"id"	"stoichiometry"	"common_name"	
"1-PFK_RXN"	{"1-PFK":1,"1-PFK-MONOMER":-2}	null	
"2OXOGLUTARATEDEH-CPLX_RXN"	{"2OXOGLUTARATEDEH-CPLX":1,"E1O":-1,"E2O":-1,"E3-CPLX":-1}	"2-oxoglutarate dehydrogenase complex"	
"3-ISOPROPYLMALDEHYDROG-CPLX_RXN"	{"3-ISOPROPYLMALDEHYDROG-CPLX":1,"3-ISOPROPYLMALDEHYDROG-MONOMER":-2}	null	
"3-ISOPROPYLMALISOM-CPLX_RXN"	{"3-ISOPROPYLMALISOM-CPLX":1,"LEUC-MONOMER":-1,"LEUD-MONOMER":-1}	"3-isopropylmalate dehydratase"	
"3-METHYL-2-OXOBUT-OHCH3XFER-CPLX_RXN"	{"3-METHYL-2-OXOBUT-OHCH3XFER-CPLX":1,"3-CH3-2-OXOBUTANOATE-OH-CH3-XFER-MONOMER":-10}	null	
"3-OXOACYL-ACP-SYNTHII-CPLX_RXN"	{"3-OXOACYL-ACP-SYNTHII-CPLX":1,"3-OXOACYL-ACP-SYNTHII-MONOMER":-2}	"3-oxoacyl-[acyl carrier protein] synthase 2"	
"6PFK-1-CPX_RXN"	{"6PFK-1-CPX":1,"6PFK-1-MONOMER":-4}	"6-phosphofructokinase 1"	
"6PFK-2-CPX_RXN"	{"6PFK-2-CPX":1,"6PFK-2-MONOMER":-2}	"6-phosphofructokinase 2"	
"6PGLUCONDEHYDROG-CPLX_RXN"	{"6PGLUCONDEHYDROG-CPLX":1,"6PGLUCONDEHYDROG-MONOMER":-2}	null	
"7-ALPHA-HYDROXYSTEROID-DEH-CPLX_RXN"	{"7-ALPHA-HYDROXYSTEROID-DEH-CPLX":1,"7-ALPHA-HYDROXYSTEROID-DEH-MONOMER":-4}	null	
"7KAPSYN-CPLX_RXN"	{"7KAPSYN-CPLX":1,"7KAPSYN-MONOMER":-2}	null	
"ABC-10-CPLX_RXN"	{"ABC-10-CPLX":1,"FEPC-MONOMER":-2,"FEPD-MONOMER":-1,"FEPG-MONOMER":-1,"FEPB-MONOMER":-1}	"ferric enterobactin ABC transporter"	
"ABC-11-CPLX_RXN"	{"ABC-11-CPLX":1,"FHUC-MONOMER":-2,"FHUB-MONOMER":-1,"FHUD-MONOMER":-1}	"iron(III) hydroxamate ABC transporter"	
"ABC-12-CPLX_RXN"	{"ABC-12-CPLX":1,"GLNQ-MONOMER":-2,"GLNP-MONOMER":-2,"GLNH-MONOMER":-1}	"L-glutamine ABC transporter"	
"ABC-13-CPLX_RXN"	{"ABC-13-CPLX":1,"G6359-MONOMER":-1,"GLTK-MONOMER":-1,"GLTJ-MONOMER":-1,"GLTL-MONOMER":-2}	"glutamate / aspartate ABC transporter"	
"ABC-14-CPLX_RXN"	{"ABC-14-CPLX":1,"HISP-MONOMER":-2,"HISM-MONOMER":-1,"HISQ-MONOMER":-1,"HISJ-MONOMER":-1}	"histidine ABC transporter"	
"ABC-15-CPLX_RXN"	{"ABC-15-CPLX":1,"LIVF-MONOMER":-1,"LIVG-MONOMER":-1,"LIVH-MONOMER":-1,"LIVM-MONOMER":-1,"LIVJ-MONOMER":-1}	"branched chain amino acid / phenylalanine ABC transporter"	
"ABC-16-CPLX_RXN"	{"ABC-16-CPLX":1,"MALK-MONOMER":-2,"MALF-MONOMER":-1,"MALG-MONOMER":-1,"MALE-MONOMER":-1}	"maltose ABC transporter"	
"ABC-18-CPLX_RXN"	{"ABC-18-CPLX":1,"MGLA-MONOMER":-1,"MGLC-MONOMER":-2,"MGLB-MONOMER":-1}	"D-galactose / methyl-&beta;-D-galactoside ABC transporter"	
"ABC-19-CPLX_RXN"	{"ABC-19-CPLX":1,"MODC-MONOMER":-1,"MODB-MONOMER":-2,"MODA-MONOMER":-1}	"molybdate ABC transporter"	
"ABC-2-CPLX_RXN"	{"ABC-2-CPLX":1,"ARAG-MONOMER":-2,"ARAH-MONOMER":-2,"ARAF-MONOMER":-1}	"arabinose ABC transporter"	
"ABC-20-CPLX_RXN"	{"ABC-20-CPLX":1,"NIKD-MONOMER":-1,"NIKE-MONOMER":-1,"NIKB-MONOMER":-1,"NIKC-MONOMER":-1,"NIKA-MONOMER":-1}	"Ni(2+) ABC transporter"	
"ABC-21-CPLX_RXN"	{"ABC-21-CPLX":1,"YADG-MONOMER":-1,"YADH-MONOMER":-1}	"putative transport complex, ABC superfamily"	
"ABC-22-CPLX_RXN"	{"ABC-22-CPLX":1,"OPPC-MONOMER":-1,"OPPD-MONOMER":-1,"OPPF-MONOMER":-1,"OPPB-MONOMER":-1,"OPPA-MONOMER":-1}	"oligopeptide ABC transporter"	
"ABC-23-CPLX_RXN"	{"ABC-23-CPLX":1,"PHNC-MONOMER":-2,"PHNE-MONOMER":-2,"PHND-MONOMER":-1}	"cryptic phosphonate/phosphate ABC transporter"	
"ABC-24-CPLX_RXN"	{"ABC-24-CPLX":1,"POTA-MONOMER":-2,"POTB-MONOMER":-1,"POTC-MONOMER":-1,"POTD-MONOMER":-1}	"spermidine preferential ABC transporter"	
"ABC-25-CPLX_RXN"	{"ABC-25-CPLX":1,"POTG-MONOMER":-2,"POTH-MONOMER":-1,"POTI-MONOMER":-1,"POTF-MONOMER":-1}	"putrescine ABC transporter"	
"ABC-26-CPLX_RXN"	{"ABC-26-CPLX":1,"PROV-MONOMER":-2,"PROW-MONOMER":-2,"PROX-MONOMER":-1}	"glycine betaine ABC transporter"	
"ABC-27-CPLX_RXN"	{"ABC-27-CPLX":1,"PSTB-MONOMER":-2,"PSTA-MONOMER":-1,"PSTC-MONOMER":-1,"PSTS-MONOMER":-1}	"phosphate ABC transporter"	
"ABC-28-CPLX_RXN"	{"ABC-28-CPLX":1,"RBSA-MONOMER":-1,"RBSC-MONOMER":-2,"RBSB-MONOMER":-1}	"ribose ABC transporter"	
"ABC-29-CPLX_RXN"	{"ABC-29-CPLX":1,"SAPF-MONOMER":-1,"SAPC-MONOMER":-1,"SAPB-MONOMER":-1,"SAPD-MONOMER":-1}	"putrescine ABC exporter"	
"ABC-3-CPLX_RXN"	{"ABC-3-CPLX":1,"HISQ-MONOMER":-1,"HISP-MONOMER":-2,"HISM-MONOMER":-1,"ARGT-MONOMER":-1}	"lysine / arginine / ornithine ABC transporter"	
"ABC-304-CPLX_RXN"	{"ABC-304-CPLX":1,"LIVK-MONOMER":-1,"LIVM-MONOMER":-1,"LIVH-MONOMER":-1,"LIVG-MONOMER":-1,"LIVF-MONOMER":-1}	"leucine / L-phenylalanine ABC transporter"	
"ABC-32-CPLX_RXN"	{"ABC-32-CPLX":1,"SFUC-MONOMER":-2,"SFUB-MONOMER":-2,"SFUA-MONOMER":-1}	"thiamine ABC transporter"	
"ABC-33-CPLX_RXN"	{"ABC-33-CPLX":1,"XYLG-MONOMER":-1,"XYLH-MONOMER":-2,"XYLF-MONOMER":-1}	"xylose ABC transporter"	
"ABC-34-CPLX_RXN"	{"ABC-34-CPLX":1,"UGPC-MONOMER":-2,"UGPA-MONOMER":-1,"UGPE-MONOMER":-1,"UGPB-MONOMER":-1}	"<i>sn</i>-glycerol 3-phosphate / glycerophosphodiester ABC transporter"	
"ABC-35-CPLX_RXN"	{"ABC-35-CPLX":1,"CCMC-MONOMER":-1,"EG12169-MONOMER":-1,"CCME-MONOMER":-1}	"CcmCDE complex"	
"ABC-4-CPLX_RXN"	{"ABC-4-CPLX":1,"ARTJ-MONOMER":-1,"ARTQ-MONOMER":-1,"ARTM-MONOMER":-1,"ARTP-MONOMER":-2}	"L-arginine ABC transporter"	
"ABC-40-CPLX_RXN"	{"ABC-40-CPLX":1,"YEHZ-MONOMER":null,"YEHY-MONOMER":null,"YEHX-MONOMER":null,"YEHW-MONOMER":null}	"glycine betaine ABC transporter, non-osmoregulatory"	
"ABC-41-CPLX_RXN"	{"ABC-41-CPLX":1,"YEJF-MONOMER":-1,"YEJB-MONOMER":-1,"YEJE-MONOMER":-1,"YEJA-MONOMER":-1}	null	
"ABC-42-CPLX_RXN"	{"ABC-42-CPLX":1,"YJCW-MONOMER":-1,"YJCV-MONOMER":-2,"YJCX-MONOMER":-1}	null	
"ABC-45-CPLX_RXN"	{"ABC-45-CPLX":1,"G7658-MONOMER":-2,"EG12799-MONOMER":-6,"YRBE-MONOMER":-2,"YRBF-MONOMER":-2}	"intermembrane phospholipid transport system"	
"ABC-46-CPLX_RXN"	{"ABC-46-CPLX":1,"YJFF-MONOMER":-1,"YTFR-MONOMER":-1,"YTFT-MONOMER":-1,"YTFQ-MONOMER":-1}	"galactofuranose ABC transporter"	
"ABC-48-CPLX_RXN"	{"ABC-48-CPLX":1,"YNJC-MONOMER":null,"YNJD-MONOMER":null,"G6949-MONOMER":null}	"putative transport complex, ABC superfamily"	
"ABC-49-CPLX_RXN"	{"ABC-49-CPLX":1,"YLIA-MONOMER":-1,"YLIB-MONOMER":-1,"YLID-MONOMER":-1,"YLIC-MONOMER":-1}	"glutathione ABC transporter"	
"ABC-5-CPLX_RXN"	{"ABC-5-CPLX":1,"BTUD-MONOMER":-2,"BTUC-MONOMER":-2,"EG12334-MONOMER":-1}	"vitamin B<sub>12</sub> ABC transporter"	
"ABC-51-CPLX_RXN"	{"ABC-51-CPLX":1,"YDCS-MONOMER":-1,"YDCT-MONOMER":-1,"YDCV-MONOMER":-1,"YDCU-MONOMER":-1}	"putative transport complex, ABC superfamily"	
"ABC-52-CPLX_RXN"	{"ABC-52-CPLX":1,"YHDZ-MONOMER":-1,"YHDY-MONOMER":-1,"YHDX-MONOMER":-1,"YHDW-MONOMER":-1}	"putative transport complex, ABC superfamily"	
"ABC-54-CPLX_RXN"	{"ABC-54-CPLX":1,"FTSE-MONOMER":-2,"FTSX-MONOMER":-1}	"divisome protein complex FtsEX"	
"ABC-55-CPLX_RXN"	{"ABC-55-CPLX":1,"YCJP-MONOMER":-1,"YCJO-MONOMER":-1,"YCJN-MONOMER":-1,"YCJV-MONOMER":-1}	"putative transport complex, ABC superfamily"	
"ABC-56-CPLX_RXN"	{"ABC-56-CPLX":1,"G6478-MONOMER":-1,"YCBM-MONOMER":-2,"YCBE-MONOMER":-2}	"aliphatic sulfonate ABC transporter"	
"ABC-57-CPLX_RXN"	{"ABC-57-CPLX":1,"YBHS-MONOMER":-1,"YBHR-MONOMER":-1,"YBHF-MONOMER":-1}	"ABC exporter YbhFSR"	
"ABC-58-CPLX_RXN"	{"ABC-58-CPLX":1,"YNEA-MONOMER":-1,"YDEZ-MONOMER":-1,"YDEY-MONOMER":-1,"YDEX-MONOMER":-2}	null	
"ABC-59-CPLX_RXN"	{"ABC-59-CPLX":1,"YDDR-MONOMER":-1,"YDDQ-MONOMER":-1,"YDDS-MONOMER":-1,"YDDP-MONOMER":-1,"YDDO-MONOMER":-1}	"putative D,D-dipeptide ABC transporter"	
"ABC-6-CPLX_RXN"	{"ABC-6-CPLX":1,"CYDD-MONOMER":-1,"CYDC-MONOMER":-1}	"glutathione / L-cysteine ABC exporter CydDC"	
"ABC-60-CPLX_RXN"	{"ABC-60-CPLX":1,"YPHD-MONOMER":null,"G7342-MONOMER":null,"YPHE-MONOMER":null}	"putative transport complex, ABC superfamily"	
"ABC-61-CPLX_RXN"	{"ABC-61-CPLX":1,"YBBP-MONOMER":-1,"YBBA-MONOMER":-1}	"putative transport complex, ABC superfamily"	
"ABC-62-CPLX_RXN"	{"ABC-62-CPLX":1,"YCFW-MONOMER":-1,"YCFV-MONOMER":-2,"YCFU-MONOMER":-1}	"lipoprotein release complex"	
"ABC-63-CPLX_RXN"	{"ABC-63-CPLX":1,"ZNUC-MONOMER":-2,"ZNUB-MONOMER":-2,"ZNUA-MONOMER":-1}	null	
"ABC-64-CPLX_RXN"	{"ABC-64-CPLX":1,"TAUA-MONOMER":-1,"TAUC-MONOMER":-2,"TAUB-MONOMER":-2}	null	
"ABC-7-CPLX_RXN"	{"ABC-7-CPLX":1,"CYSA-MONOMER":-2,"CYSW-MONOMER":-1,"CYST-MONOMER":-1,"CYSP-MONOMER":-1}	"thiosulfate/sulfate ABC transporter"	
"ABC-70-CPLX_RXN"	{"ABC-70-CPLX":1,"SBP-MONOMER":-1,"CYSW-MONOMER":-1,"CYST-MONOMER":-1,"CYSA-MONOMER":-2}	"sulfate/thiosulfate ABC transporter"	
"ABC-8-CPLX_RXN"	{"ABC-8-CPLX":1,"DPPD-MONOMER":-1,"DPPF-MONOMER":-1,"DPPB-MONOMER":-1,"DPPC-MONOMER":-1,"DPPA-MONOMER":-1}	"dipeptide ABC transporter"	
"ABC-9-CPLX_RXN"	{"ABC-9-CPLX":1,"FECE-MONOMER":-2,"FECC-MONOMER":-1,"FECD-MONOMER":-1,"FECB-MONOMER":-1}	"ferric citrate ABC transporter"	
"ACETOACETYL-COA-TRANSFER-CPLX_RXN"	{"ACETOACETYL-COA-TRANSFER-CPLX":1,"ATOA-CPLX":-1,"ATOD-CPLX":-1}	null	
"ACETOLACTSYNI-CPLX_RXN"	{"ACETOLACTSYNI-CPLX":1,"LARGEILVB-MONOMER":-2,"SMALLILVN-MONOMER":-2}	null	
"ACETOLACTSYNII-CPLX_RXN"	{"ACETOLACTSYNII-CPLX":1,"G8221-MONOMER":null,"SMALLILVM-MONOMER":null}	null	
"ACETOLACTSYNIII-CPLX_RXN"	{"ACETOLACTSYNIII-CPLX":1,"ACETOLACTSYNIII-ICHAIN-MONOMER":-2,"ACETOLACTSYNIII-HCHAIN-MONOMER":-2}	null	
"ACETYL-COA-ACETYLTRANSFER-CPLX_RXN"	{"ACETYL-COA-ACETYLTRANSFER-CPLX":1,"ACETYL-COA-ACETYLTRANSFER-MONOMER":-4}	null	
"ACETYL-COA-CARBOXYLMULTI-CPLX_RXN"	{"ACETYL-COA-CARBOXYLMULTI-CPLX":1,"ACETYL-COA-CARBOXYLTRANSFER-CPLX":-1,"BIOTIN-CARBOXYL-CPLX":-1,"BCCP-CPLX":-1}	"acetyl-CoA carboxylase complex"	
"ACETYL-COA-CARBOXYLTRANSFER-CPLX_RXN"	{"ACETYL-COA-CARBOXYLTRANSFER-CPLX":1,"CARBOXYL-TRANSFERASE-ALPHA-MONOMER":-2,"CARBOXYL-TRANSFERASE-BETA-MONOMER":-2}	null	
"ACETYLGLUTKIN-CPLX_RXN"	{"ACETYLGLUTKIN-CPLX":1,"ACETYLGLUTKIN-MONOMER":-2}	"acetylglutamate kinase"	
"ACETYLORNDEACET-CPLX_RXN"	{"ACETYLORNDEACET-CPLX":1,"ACETYLORNDEACET-MONOMER":-2}	null	
"ACETYLORNTRANSAM-CPLX_RXN"	{"ACETYLORNTRANSAM-CPLX":1,"ACETYLORNTRANSAM-MONOMER":-2}	"<i>N</i>-acetylornithine aminotransferase / <i>N</i>-succinyldiaminopimelate aminotransferase"	
"ACNEULY-CPLX_RXN"	{"ACNEULY-CPLX":1,"ACNEULY-MONOMER":-4}	null	
"ACSERLYA-CPLX_RXN"	{"ACSERLYA-CPLX":1,"ACSERLYA-MONOMER":-2}	"cysteine synthase A"	
"ACSERLYB-CPLX_RXN"	{"ACSERLYB-CPLX":1,"ACSERLYB-MONOMER":-2}	"cysteine synthase B"	
"ACYLCOASYN-CPLX_RXN"	{"ACYLCOASYN-CPLX":1,"ACYLCOASYN-MONOMER":-2}	"long-chain-fatty-acid&mdash;CoA ligase"	
"ADCLY-CPLX_RXN"	{"ADCLY-CPLX":1,"ADCLY-MONOMER":-2}	null	
"ADENPRIBOSYLTRAN-CPLX_RXN"	{"ADENPRIBOSYLTRAN-CPLX":1,"ADENPRIBOSYLTRAN-MONOMER":-2}	null	
"ADENYLOSUCCINATE-SYN-DIMER_RXN"	{"ADENYLOSUCCINATE-SYN-DIMER":1,"ADENYLOSUCCINATE-SYN-MONOMER":-2}	"adenylosuccinate synthetase"	
"ADENYLYLSULFKIN-CPLX_RXN"	{"ADENYLYLSULFKIN-CPLX":1,"ADENYLYLSULFKIN-MONOMER":-2}	null	
"ADHC-CPLX_RXN"	{"ADHC-CPLX":1,"ADHC-MONOMER":-2}	null	
"ADHE-CPLX_RXN"	{"ADHE-CPLX":1,"ADHE-MONOMER":-40}	"fused acetaldehyde-CoA dehydrogenase and iron-dependent alcohol dehydrogenase"	
"AERGLYC3PDEHYDROG-CPLX_RXN"	{"AERGLYC3PDEHYDROG-CPLX":1,"AERGLYC3PDEHYDROG-MONOMER":-2}	null	
"AGMATIN-CPLX_RXN"	{"AGMATIN-CPLX":1,"AGMATIN-MONOMER":-2}	null	
"AIRS-CPLX_RXN"	{"AIRS-CPLX":1,"AIRS-MONOMER":-2}	null	
"AKBLIG-CPLX_RXN"	{"AKBLIG-CPLX":1,"AKBLIG-MONOMER":-2}	null	
"ALAS-CPLX_RXN"	{"ALAS-CPLX":1,"ALAS-MONOMER":-2}	"alanine&mdash;tRNA ligase/DNA-binding transcriptional repressor"	
"ALD-CPLX_RXN"	{"ALD-CPLX":1,"LACTALDDEHYDROG-MONOMER":-4}	"aldehyde dehydrogenase A, NAD-linked"	
"ALKAPHOSPHA-CPLX_RXN"	{"ALKAPHOSPHA-CPLX":1,"ALKAPHOSPHA-MONOMER":-2}	"alkaline phosphatase"	
"ALPHA-SUBUNIT-CPLX_RXN"	{"ALPHA-SUBUNIT-CPLX":1,"FDNI-MONOMER":-1,"FDNH-MONOMER":-1,"FDNG-MONOMER":-1}	"formate dehydrogenase N, subcomplex"	
"ALPHAGALACTOSID-CPLX_RXN"	{"ALPHAGALACTOSID-CPLX":1,"ALPHAGALACTOSID-MONOMER":-2}	null	
"AMINEOXID-CPLX_RXN"	{"AMINEOXID-CPLX":1,"AMINEOXID-MONOMER":-2}	"copper-containing amine oxidase"	
"AMP-NUCLEOSID-CPLX_RXN"	{"AMP-NUCLEOSID-CPLX":1,"AMP-NUCLEOSID-MONOMER":-6}	null	
"ANGLYC3PDEHYDROG-CPLX_RXN"	{"ANGLYC3PDEHYDROG-CPLX":1,"ANGLYC3PDEHYDROGSUBUNITA-MONOMER":-1,"ANGLYC3PDEHYDROGSUBUNITB-MONOMER":-1,"ANGLYC3PDEHYDROGSUBUNITC-MONOMER":-1}	"anaerobic glycerol-3-phosphate dehydrogenase"	
"ANSA-CPLX_RXN"	{"ANSA-CPLX":1,"ANSA-MONOMER":-4}	"L-asparaginase 1"	
"ANSB-CPLX_RXN"	{"ANSB-CPLX":1,"ANSB-MONOMER":-4}	"L-asparaginase 2"	
"ANTHRANSYN-CPLX_RXN"	{"ANTHRANSYN-CPLX":1,"ANTHRANSYNCOMPI-MONOMER":-2,"ANTHRANSYNCOMPII-MONOMER":-2}	null	
"APHA-CPLX_RXN"	{"APHA-CPLX":1,"APHA-MONOMER":-4}	"acid phosphatase / phosphotransferase"	
"APORNAP-CPLX_RXN"	{"APORNAP-CPLX":1,"EG10893-MONOMER":-2,"RPOC-MONOMER":-1,"RPOB-MONOMER":-1}	"RNA polymerase, core enzyme"	
"APP-UBIOX-CPLX_RXN"	{"APP-UBIOX-CPLX":1,"APPC-MONOMER":-1,"APPB-MONOMER":-1}	"cytochrome <i>bd</i>-II ubiquinol oxidase"	
"ARABISOM-CPLX_RXN"	{"ARABISOM-CPLX":1,"ARABISOM-MONOMER":-6}	"L-arabinose isomerase"	
"ARGDECARBOXBIO-CPLX_RXN"	{"ARGDECARBOXBIO-CPLX":1,"ARGDECARBOXBIO-MONOMER":-4}	null	
"ARGDECARBOXDEG-CPLX_RXN"	{"ARGDECARBOXDEG-CPLX":1,"ARGDECARBOXDEG-MONOMER":-10}	null	
"AROC-CPLX_RXN"	{"AROC-CPLX":1,"AROC-MONOMER":-4}	null	
"AROD-CPLX_RXN"	{"AROD-CPLX":1,"AROD-MONOMER":-2}	null	
"AROF-CPLX_RXN"	{"AROF-CPLX":1,"AROF-MONOMER":-2}	null	
"AROG-CPLX_RXN"	{"AROG-CPLX":1,"AROG-MONOMER":-4}	null	
"AROH-CPLX_RXN"	{"AROH-CPLX":1,"AROH-MONOMER":-2}	null	
"ASNS-CPLX_RXN"	{"ASNS-CPLX":1,"ASNS-MONOMER":-2}	null	
"ASNSYNA-CPLX_RXN"	{"ASNSYNA-CPLX":1,"ASNSYNA-MONOMER":-2}	"asparagine synthetase A"	
"ASNSYNB-CPLX_RXN"	{"ASNSYNB-CPLX":1,"ASNSYNB-MONOMER":-2}	"asparagine synthetase B"	
"ASP-SEMIALDEHYDE-DEHYDROGENASE-CPLX_RXN"	{"ASP-SEMIALDEHYDE-DEHYDROGENASE-CPLX":1,"ASP-SEMIALDEHYDE-DEHYDROGENASE-MONOMER":-2}	null	
"ASPAMINOTRANS-DIMER_RXN"	{"ASPAMINOTRANS-DIMER":1,"ASPAMINOTRANS-MONOMER":-2}	"aspartate aminotransferase"	
"ASPARTASE-CPLX_RXN"	{"ASPARTASE-CPLX":1,"ASPARTASE-MONOMER":-4}	null	
"ASPCARBCAT-TRIMER_RXN"	{"ASPCARBCAT-TRIMER":1,"ASPCARBCAT-MONOMER":-3}	"aspartate carbamoyltransferase catalytic subunit"	
"ASPCARBREG-DIMER_RXN"	{"ASPCARBREG-DIMER":1,"ASPCARBREG-MONOMER":-2}	"aspartate carbamoyltransferase, regulatory subunit"	
"ASPCARBTRANS-CPLX_RXN"	{"ASPCARBTRANS-CPLX":1,"ASPCARBCAT-TRIMER":-2,"ASPCARBREG-DIMER":-3}	null	
"ASPKINIHOMOSERDEHYDROGI-CPLX_RXN"	{"ASPKINIHOMOSERDEHYDROGI-CPLX":1,"ASPKINIHOMOSERDEHYDROGI-MONOMER":-4}	"fused aspartate kinase/homoserine dehydrogenase 1"	
"ASPKINIIHOMOSERDEHYDROGII-CPLX_RXN"	{"ASPKINIIHOMOSERDEHYDROGII-CPLX":1,"ASPKINIIHOMOSERDEHYDROGII-MONOMER":-2}	"fused aspartate kinase/homoserine dehydrogenase 2"	
"ASPKINIII-CPLX_RXN"	{"ASPKINIII-CPLX":1,"ASPKINIII-MONOMER":-2}	"aspartate kinase III"	
"ASPS-CPLX_RXN"	{"ASPS-CPLX":1,"ASPS-MONOMER":-2}	null	
"ATOA-CPLX_RXN"	{"ATOA-CPLX":1,"ATOA-MONOMER":-2}	"&beta; complex"	
"ATOD-CPLX_RXN"	{"ATOD-CPLX":1,"ATOD-MONOMER":-2}	"&alpha; complex"	
"ATPA-CPLX_RXN"	{"ATPA-CPLX":1,"ATPA-MONOMER":-3}	"ATP synthase F<sub>1</sub> complex subunit &alpha;"	
"ATPASE-1-CPLX_RXN"	{"ATPASE-1-CPLX":1,"MONOMER0-12":-1,"EG10513-MONOMER":-1,"KDPB-MONOMER":-1,"EG10515-MONOMER":-1}	"K<sup>+</sup> transporting P-type ATPase"	
"ATPD-CPLX_RXN"	{"ATPD-CPLX":1,"ATPD-MONOMER":-3}	"ATP synthase F<sub>1</sub> complex subunit &beta;"	
"ATPE-CPLX_RXN"	{"ATPE-CPLX":1,"ATPE-MONOMER":-10}	"ATP synthase F<sub>o</sub> complex - subunit c"	
"ATPF-CPLX_RXN"	{"ATPF-CPLX":1,"ATPF-MONOMER":-2}	"ATP synthase F<sub>o</sub> complex - subunit b"	
"ATPSYN-CPLX_RXN"	{"ATPSYN-CPLX":1,"F-O-CPLX":-1,"F-1-CPLX":-1}	null	
"B1-CPLX_RXN"	{"B1-CPLX":1,"NRDA-MONOMER":-2}	"ribonucleoside-diphosphate reductase 1, &alpha; subunit dimer"	
"B2-CPLX_RXN"	{"B2-CPLX":1,"NRDB-MONOMER":-2}	"ribonucleoside-diphosphate reductase 1, &beta; subunit dimer"	
"BADH-CPLX_RXN"	{"BADH-CPLX":1,"BADH-MONOMER":-4}	null	
"BCCP-CPLX_RXN"	{"BCCP-CPLX":1,"BCCP-BIOTIN":-2}	"biotin carboxyl carrier protein (dimer)"	
"BETAGALACTOSID-CPLX_RXN"	{"BETAGALACTOSID-CPLX":1,"BETAGALACTOSID-MONOMER":-4}	"&beta;-galactosidase"	
"BIOTIN-CARBOXYL-CPLX_RXN"	{"BIOTIN-CARBOXYL-CPLX":1,"BIOTIN-CARBOXYL-MONOMER":-2}	null	
"BIOTIN-SYN-CPLX_RXN"	{"BIOTIN-SYN-CPLX":1,"BIOTIN-SYN-MONOMER":-2}	"biotin synthase"	
"BRANCHED-CHAINAMINOTRANSFER-CPLX_RXN"	{"BRANCHED-CHAINAMINOTRANSFER-CPLX":1,"BRANCHED-CHAINAMINOTRANSFER-MONOMER":-6}	"branched-chain-amino-acid aminotransferase"	
"CARBODEHYDRAT-CPLX_RXN"	{"CARBODEHYDRAT-CPLX":1,"CARBODEHYDRAT-MONOMER":-2}	"carbonic anhydrase 1"	
"CARBPSYN-CPLX_RXN"	{"CARBPSYN-CPLX":1,"CARBPSYN-LARGE":-2,"CARBPSYN-SMALL":-2}	null	
"CARNDEHYDRA-CPLX_RXN"	{"CARNDEHYDRA-CPLX":1,"CARNDEHYDRA-MONOMER":-2}	null	
"CFA-CPLX_RXN"	{"CFA-CPLX":1,"CFA-MONOMER":-2}	null	
"CHEZ-CPLX_RXN"	{"CHEZ-CPLX":1,"CHEZ-MONOMER":-2}	"chemotaxis protein CheZ"	
"CHORISMUTPREPHENDEHYDRAT-CPLX_RXN"	{"CHORISMUTPREPHENDEHYDRAT-CPLX":1,"CHORISMUTPREPHENDEHYDRAT-MONOMER":-2}	"fused chorismate mutase/prephenate dehydratase"	
"CHORISMUTPREPHENDEHYDROG-CPLX_RXN"	{"CHORISMUTPREPHENDEHYDROG-CPLX":1,"CHORISMUTPREPHENDEHYDROG-MONOMER":-2}	"fused chorismate mutase/prephenate dehydrogenase"	
"CITLY-CPLX_RXN"	{"CITLY-CPLX":1,"ACPSUB-CPLX":-1,"CITTRANS-CPLX":-1,"CITRYLY-CPLX":-1}	"citrate lyase, inactive"	
"CITRATE-SI-SYNTHASE_RXN"	{"CITRATE-SI-SYNTHASE":1,"CITSYN-MONOMER":-6}	null	
"CITRYLY-CPLX_RXN"	{"CITRYLY-CPLX":1,"CITRYLY-MONOMER":-6}	"citrate lyase, citryl-acyl carrrier protein lyase component"	
"CITTRANS-CPLX_RXN"	{"CITTRANS-CPLX":1,"CITTRANS-MONOMER":-6}	"citrate lyase, citrate-acyl carrier protein transferase component"	
"COADTRI-CPLX_RXN"	{"COADTRI-CPLX":1,"PANTEPADENYLYLTRAN-MONOMER":-6}	null	
"COBU-CPLX_RXN"	{"COBU-CPLX":1,"COBU-MONOMER":-2}	null	
"CPLX-153_RXN"	{"CPLX-153":1,"ASCF-MONOMER":-2}	"&beta;-glucoside specific PTS enzyme II"	
"CPLX-154_RXN"	{"CPLX-154":1,"BGLF-MONOMER":-2}	"&beta;-glucoside specific PTS enzyme II / BglG kinase / BglG phosphatase"	
"CPLX-155_RXN"	{"CPLX-155":1,"CELC-MONOMER":-1,"CELB-MONOMER":-1,"CELA-MONOMER":-1}	"<I>N,N'</I>-diacetylchitobiose-specific PTS enzyme II"	
"CPLX-156_RXN"	{"CPLX-156":1,"CMTB-MONOMER":-1,"CMTA-MONOMER":-1}	"mannitol-specific PTS enzyme II CmtBA"	
"CPLX-157_RXN"	{"CPLX-157":1,"PTSG-MONOMER":-2,"CRR-MONOMER":-1}	"glucose-specific PTS enzyme II"	
"CPLX-158_RXN"	{"CPLX-158":1,"FRUB-MONOMER":-1,"FRUA-MONOMER":-2}	"fructose-specific PTS enzyme II"	
"CPLX-159_RXN"	{"CPLX-159":1,"FRVB-MONOMER":-1,"FRVA-MONOMER":-1}	"putative PTS enzyme II FrvAB"	
"CPLX-160_RXN"	{"CPLX-160":1,"FRWC-MONOMER":-1,"FRWB-MONOMER":-1,"EG11912-MONOMER":-1,"EG11906-MONOMER":-1}	"putative PTS enzyme II FrwCBDPtsA"	
"CPLX-165_RXN"	{"CPLX-165":1,"MANZ-MONOMER":-3,"MANY-MONOMER":-3,"MANX-MONOMER":-1}	"mannose-specific PTS enzyme II"	
"CPLX-166_RXN"	{"CPLX-166":1,"MTLA-MONOMER":-2}	"mannitol-specific PTS enzyme II"	
"CPLX-167_RXN"	{"CPLX-167":1,"NAGE-MONOMER":-2}	"N-acetylglucosamine-specific PTS enzyme II"	
"CPLX-168_RXN"	{"CPLX-168":1,"TREB-MONOMER":-2,"CRR-MONOMER":-1}	"trehalose-specific PTS enzyme II"	
"CPLX-169_RXN"	{"CPLX-169":1,"G8210-MONOMER":-1,"GUTB-MONOMER":-1,"GUTA-MONOMER":-1}	"sorbitol-specific PTS enzyme II"	
"CPLX-170_RXN"	{"CPLX-170":1,"AGAB-MONOMER":-1,"AGAC-MONOMER":-1,"AGAD-MONOMER":-1}	"galactosamine-specific PTS enzyme II (cryptic)"	
"CPLX-171_RXN"	{"CPLX-171":1,"G6277-MONOMER":-2}	null	
"CPLX-3942_RXN"	{"CPLX-3942":1,"G7712-MONOMER":-2,"G7713-MONOMER":-2,"G7714-MONOMER":-2}	"sulfurtransferase complex TusBCD"	
"CPLX-3945_RXN"	{"CPLX-3945":1,"G6544-MONOMER":-9,"G6543-MONOMER":-9}	null	
"CPLX-3946_RXN"	{"CPLX-3946":1,"EG11072-MONOMER":-1,"EG11098-MONOMER":-4}	"exodeoxyribonuclease VII"	
"CPLX-64_RXN"	{"CPLX-64":1,"G6281-MONOMER":-4}	null	
"CPLX-722_RXN"	{"CPLX-722":1,"APPA-MONOMER":-2}	"periplasmic phosphoanhydride phosphatase/multiple inositol-polyphosphate phosphatase"	
"CPLX-7524_RXN"	{"CPLX-7524":1,"G6285-MONOMER":-2}	"allantoate amidohydrolase"	
"CPLX-7_RXN"	{"CPLX-7":1,"ARSF-MONOMER":-2}	"arsenite/antimonite:H<sup>+</sup> antiporter"	
"CPLX-8331_RXN"	{"CPLX-8331":1,"EG11666-MONOMER":-6}	"cyclic pyranopterin monophosphate synthase"	
"CPLX-8401_RXN"	{"CPLX-8401":1,"G7463-MONOMER":-6}	"5-dehydro-4-deoxy-<small>D</small>-glucuronate isomerase"	
"CPLX-9493_RXN"	{"CPLX-9493":1,"CCMB-MONOMER":-1,"CCMA-MONOMER":-2}	"CcmAB"	
"CPLX-9494_RXN"	{"CPLX-9494":1,"EG12052-MONOMER":-1,"EG12054-MONOMER":-1}	"holocytochrome <I>c</I> synthase complex"	
"CPLX-9495_RXN"	{"CPLX-9495":1,"EG12169-MONOMER":-1,"CCMC-MONOMER":-1,"CCMB-MONOMER":-1,"CCMA-MONOMER":-2}	"CcmABCD release complex"	
"CPLX0-0_RXN"	{"CPLX0-0":1,"EG10244-MONOMER":-3}	"primosomal protein DnaT"	
"CPLX0-1021_RXN"	{"CPLX0-1021":1,"G6196-MONOMER":-4}	"2-methylisocitrate lyase"	
"CPLX0-1101_RXN"	{"CPLX0-1101":1,"EG10996-MONOMER":-3}	"tRNA-guanine transglycosylase"	
"CPLX0-1121_RXN"	{"CPLX0-1121":1,"G7845-MONOMER":-2}	"23S rRNA 2'-<i>O</i>-ribose G2251 methyltransferase"	
"CPLX0-1141_RXN"	{"CPLX0-1141":1,"EG10941-MONOMER":-10}	"selenocysteine synthase"	
"CPLX0-1142_RXN"	{"CPLX0-1142":1,"G7237-MONOMER":-2}	"formyl-CoA transferase"	
"CPLX0-1161_RXN"	{"CPLX0-1161":1,"EG11881-MONOMER":-6}	"HslU hexamer"	
"CPLX0-1162_RXN"	{"CPLX0-1162":1,"EG11676-MONOMER":-6}	"HslV hexamer"	
"CPLX0-1163_RXN"	{"CPLX0-1163":1,"CPLX0-1161":-2,"CPLX0-1162":-2}	"HslVU protease"	
"CPLX0-1221_RXN"	{"CPLX0-1221":1,"G7740-MONOMER":-2}	"ADP-sugar diphosphatase NudE"	
"CPLX0-1241_RXN"	{"CPLX0-1241":1,"EG11249-MONOMER":-2}	"MazF toxin of the MazF-MazE toxin-antitoxin system that exhibits ribonuclease activity"	
"CPLX0-1242_RXN"	{"CPLX0-1242":1,"CPLX0-1241":-2,"CPLX0-841":-1}	"MazE-MazF antitoxin/toxin complex / DNA-binding transcriptional repressor"	
"CPLX0-1261_RXN"	{"CPLX0-1261":1,"TRANSKETOII-MONOMER":null}	"transketolase 2"	
"CPLX0-1262_RXN"	{"CPLX0-1262":1,"G7662-MONOMER":-4}	"D-arabinose 5-phosphate isomerase KdsD"	
"CPLX0-1321_RXN"	{"CPLX0-1321":1,"EG10436-MONOMER":-1,"EG10435-MONOMER":-1}	"HflK-HflC complex; regulator of FtsH protease"	
"CPLX0-1341_RXN"	{"CPLX0-1341":1,"G6909-MONOMER":-1,"G6908-MONOMER":-2,"G6907-MONOMER":-1}	"SufBC<sub>2</sub>D Fe-S cluster scaffold complex"	
"CPLX0-1401_RXN"	{"CPLX0-1401":1,"G7490-MONOMER":-2}	null	
"CPLX0-1421_RXN"	{"CPLX0-1421":1,"EG10113-MONOMER":-24}	"bacterioferritin"	
"CPLX0-1441_RXN"	{"CPLX0-1441":1,"EG10255-MONOMER":-2}	"serine protease inhibitor ecotin"	
"CPLX0-1461_RXN"	{"CPLX0-1461":1,"EG10438-MONOMER":-6}	"RNA-binding protein Hfq"	
"CPLX0-1521_RXN"	{"CPLX0-1521":1,"EG11415-MONOMER":-12}	"stationary phase nucleoid component that sequesters iron and protects DNA from damage"	
"CPLX0-1541_RXN"	{"CPLX0-1541":1,"EG11090-MONOMER":-2}	"5'-methylthioadenosine/<i>S</i>-adenosylhomocysteine nucleosidase"	
"CPLX0-1601_RXN"	{"CPLX0-1601":1,"G6845-MONOMER":-1,"G6846-MONOMER":-1,"G6847-MONOMER":-1,"G6848-MONOMER":-1}	"selenate reductase"	
"CPLX0-1621_RXN"	{"CPLX0-1621":1,"EG11299-MONOMER":-2}	"RNase G"	
"CPLX0-1642_RXN"	{"CPLX0-1642":1,"EG11879-MONOMER":-3}	"ribonuclease E inhibitor protein A"	
"CPLX0-1668_RXN"	{"CPLX0-1668":1,"G7213-MONOMER":null,"G7212-MONOMER":null}	"anaerobic fatty acid &beta;-oxidation complex"	
"CPLX0-1683_RXN"	{"CPLX0-1683":1,"EG11692-MONOMER":-2}	"adenine deaminase"	
"CPLX0-1721_RXN"	{"CPLX0-1721":1,"G6320-MONOMER":-3,"G6322-MONOMER":-6,"G6321-MONOMER":-1,"YBDE-MONOMER":-3}	"copper/silver export system"	
"CPLX0-1762_RXN"	{"CPLX0-1762":1,"G6713-MONOMER":null,"G6709-MONOMER":null,"G6711-MONOMER":null,"G6710-MONOMER":null}	"phenylacetyl-CoA 1,2-epoxidase"	
"CPLX0-1821_RXN"	{"CPLX0-1821":1,"G7842-MONOMER":-2}	"oligoribonuclease"	
"CPLX0-1841_RXN"	{"CPLX0-1841":1,"G7500-MONOMER":null,"G7499-MONOMER":null}	"predicted xanthine dehydrogenase"	
"CPLX0-1863_RXN"	{"CPLX0-1863":1,"G6379-MONOMER":-6}	"radiation resistance protein YbgI"	
"CPLX0-1881_RXN"	{"CPLX0-1881":1,"G7877-MONOMER":-3}	"enamine/imine deaminase, redox-regulated chaperone"	
"CPLX0-1923_RXN"	{"CPLX0-1923":1,"EG11012-MONOMER":null,"EG10271-MONOMER":null,"EG10272-MONOMER":null}	"energy transducing Ton complex"	
"CPLX0-1924_RXN"	{"CPLX0-1924":1,"EG10126-MONOMER":null,"CPLX0-1923":null}	"cobalamin outer membrane transport complex"	
"CPLX0-1941_RXN"	{"CPLX0-1941":1,"CPLX0-1923":null,"EG10293-MONOMER":null}	"ferric enterobactin outer membrane transport complex"	
"CPLX0-1942_RXN"	{"CPLX0-1942":1,"CPLX0-1923":null,"EG10302-MONOMER":null}	"ferrichrome outer membrane transport complex"	
"CPLX0-1943_RXN"	{"CPLX0-1943":1,"EG10286-MONOMER":null,"CPLX0-1923":null}	"ferric citrate outer membrane transport complex"	
"CPLX0-1962_RXN"	{"CPLX0-1962":1,"EG12345-MONOMER":-4}	"3-hydroxy acid dehydrogenase YdfG"	
"CPLX0-1_RXN"	{"CPLX0-1":1,"G7413-MONOMER":-4}	"reduced flavorubredoxin"	
"CPLX0-201_RXN"	{"CPLX0-201":1,"G6428-MONOMER":-10}	"fructose-6-phosphate aldolase 1"	
"CPLX0-2021_RXN"	{"CPLX0-2021":1,"EG10466-MONOMER":null,"EG10467-MONOMER":null}	"DNA-binding transcriptional dual regulator HU"	
"CPLX0-2061_RXN"	{"CPLX0-2061":1,"EG12279-MONOMER":-2}	"2,3-diketo-L-gulonate reductase"	
"CPLX0-2081_RXN"	{"CPLX0-2081":1,"G6627-MONOMER":-2,"MONOMER0-1261":-2,"CPLX0-8206":null}	"dihydroxyacetone kinase"	
"CPLX0-2121_RXN"	{"CPLX0-2121":1,"CPLX0-7964":null,"EG11354-MONOMER":null,"EMRB-MONOMER":null}	"multidrug efflux pump EmrAB-TolC"	
"CPLX0-2141_RXN"	{"CPLX0-2141":1,"CPLX0-7964":-1,"EG10266-MONOMER":-6,"ACRF-MONOMER":-3}	"multidrug efflux pump AcrEF-TolC"	
"CPLX0-2161_RXN"	{"CPLX0-2161":1,"CPLX0-7964":null,"G7233-MONOMER":null,"EMRY-MONOMER":null}	"tripartite efflux pump EmrKY-TolC"	
"CPLX0-2201_RXN"	{"CPLX0-2201":1,"EG10684-MONOMER":null,"EG11007-MONOMER":null,"EG11008-MONOMER":null,"EG11011-MONOMER":null,"EG11010-MONOMER":null}	"The Tol-Pal Cell Envelope Complex"	
"CPLX0-221_RXN"	{"CPLX0-221":1,"APORNAP-CPLX":-1,"PD00440":-1}	"RNA polymerase sigma 19"	
"CPLX0-222_RXN"	{"CPLX0-222":1,"EG11355-MONOMER":-1,"APORNAP-CPLX":-1}	"RNA polymerase sigma 28"	
"CPLX0-224_RXN"	{"CPLX0-224":1,"MONOMER0-146":-2}	"NADPH-dependent FMN reductase"	
"CPLX0-225_RXN"	{"CPLX0-225":1,"MONOMER-162":-4}	"FMNH<sub>2</sub>-dependent alkanesulfonate monooxygenase"	
"CPLX0-227_RXN"	{"CPLX0-227":1,"MONOMER0-147":-4}	"&alpha;-ketoglutarate-dependent taurine dioxygenase"	
"CPLX0-229_RXN"	{"CPLX0-229":1,"RNTRACTIV-MONOMER":-2}	"anaerobic ribonucleoside-triphosphate reductase activating protein"	
"CPLX0-230_RXN"	{"CPLX0-230":1,"ICITDEHASE-KIN-PHOSPHA":-2}	null	
"CPLX0-231_RXN"	{"CPLX0-231":1,"GATC-MONOMER":-2,"GATB-MONOMER":-1,"GATA-MONOMER":-1}	"galactitol-specific PTS enzyme II"	
"CPLX0-234_RXN"	{"CPLX0-234":1,"G7423-MONOMER":-2}	null	
"CPLX0-235_RXN"	{"CPLX0-235":1,"MONOMER-43":-2}	null	
"CPLX0-2361_RXN"	{"CPLX0-2361":1,"EG10238-MONOMER":-1,"EG10243-MONOMER":-1,"EG11505-MONOMER":-1}	"DNA polymerase III, core enzyme"	
"CPLX0-236_RXN"	{"CPLX0-236":1,"G6770-MONOMER":-2}	"arylamine <i>N</i>-acetyltransferase"	
"CPLX0-237_RXN"	{"CPLX0-237":1,"SERINE-O-ACETTRAN-MONOMER":-6}	"serine acetyltransferase"	
"CPLX0-2381_RXN"	{"CPLX0-2381":1,"PPK-CPLX":null,"CPLX0-3461":null,"CPLX0-3541":null,"CPLX0-3521":null,"ENOLASE-CPLX":null}	"degradosome"	
"CPLX0-238_RXN"	{"CPLX0-238":1,"ARGSUCCINSYN-MONOMER":-4}	null	
"CPLX0-2401_RXN"	{"CPLX0-2401":1,"TRYPSYN-BPROTEIN":-2}	"tryptophan synthase, &beta; subunit dimer"	
"CPLX0-240_RXN"	{"CPLX0-240":1,"TAGAALDOL1-MONOMER":-4}	"tagatose-1,6-bisphosphate aldolase 1"	
"CPLX0-2423_RXN"	{"CPLX0-2423":1,"EG10686-MONOMER":-2}	"dimer of DNA topoisomerase IV subunit A"	
"CPLX0-2424_RXN"	{"CPLX0-2424":1,"EG10687-MONOMER":-2,"CPLX0-2423":-1}	"DNA topoisomerase IV"	
"CPLX0-2425_RXN"	{"CPLX0-2425":1,"EG10423-MONOMER":-2,"EG10424-MONOMER":-2}	"DNA gyrase"	
"CPLX0-242_RXN"	{"CPLX0-242":1,"EG10395-MONOMER":-2}	"thiosulfate sulfurtransferase GlpE"	
"CPLX0-243_RXN"	{"CPLX0-243":1,"INORGPYROPHOSPHAT-MONOMER":-6}	"inorganic pyrophosphatase"	
"CPLX0-2441_RXN"	{"CPLX0-2441":1,"EG10845-MONOMER":-6}	"transcription termination factor Rho"	
"CPLX0-244_RXN"	{"CPLX0-244":1,"EG11261-MONOMER":-2}	null	
"CPLX0-245_RXN"	{"CPLX0-245":1,"EG11384-MONOMER":-10,"EG11385-MONOMER":-2}	"alkyl hydroperoxide reductase"	
"CPLX0-246_RXN"	{"CPLX0-246":1,"G6906-MONOMER":-2}	"L-cysteine desulfurase"	
"CPLX0-248_RXN"	{"CPLX0-248":1,"G7325-MONOMER":-2}	"cysteine desulfurase IscS"	
"CPLX0-2502_RXN"	{"CPLX0-2502":1,"EG11597-MONOMER":-2,"EG11598-MONOMER":-2}	"molybdopterin synthase"	
"CPLX0-250_RXN"	{"CPLX0-250":1,"MONOMER0-150":null,"MONOMER0-151":null,"MONOMER0-152":null,"MONOMER0-153":null,"MONOMER0-154":null,"MONOMER0-141":null,"MONOMER0-142":null,"MONOMER0-143":null,"MONOMER0-144":null}	"hydrogenase 4"	
"CPLX0-251_RXN"	{"CPLX0-251":1,"G6198-MONOMER":-2}	"2-methylcitrate synthase"	
"CPLX0-2521_RXN"	{"CPLX0-2521":1,"MONOMER0-1501":-6}	"protein MoaB"	
"CPLX0-252_RXN"	{"CPLX0-252":1,"FABH-MONOMER":-2}	"3-oxoacyl-[acyl carrier protein] synthase 3"	
"CPLX0-253_RXN"	{"CPLX0-253":1,"EG12656-MONOMER":-2}	"NADPH:quinone oxidoreductase MdaB"	
"CPLX0-2541_RXN"	{"CPLX0-2541":1,"MONOMER0-185":-2}	"DNA-binding transcriptional dual regulator ModE"	
"CPLX0-254_RXN"	{"CPLX0-254":1,"G7516-MONOMER":-6}	null	
"CPLX0-255_RXN"	{"CPLX0-255":1,"G7492-MONOMER":-4}	null	
"CPLX0-2561_RXN"	{"CPLX0-2561":1,"CPLX0-7696":null,"CPLX0-7697":null}	"bacterial condensin MukBEF"	
"CPLX0-2621_RXN"	{"CPLX0-2621":1,"MONOMER0-1564":-2}	"protein HokC"	
"CPLX0-263_RXN"	{"CPLX0-263":1,"MONOMER0-2":-2,"MONOMER0-3":-2}	"isoaspartyl dipeptidase / asparaginase III"	
"CPLX0-2641_RXN"	{"CPLX0-2641":1,"EG10461-MONOMER":-2}	"chaperone protein HtpG"	
"CPLX0-2661_RXN"	{"CPLX0-2661":1,"EG10574-MONOMER":-12,"EG10575-MONOMER":-2}	"McrBC restriction endonuclease"	
"CPLX0-2681_RXN"	{"CPLX0-2681":1,"EG10978-MONOMER":-2}	"ClpXP protease specificity-enhancing factor"	
"CPLX0-2861_RXN"	{"CPLX0-2861":1,"EG10116-MONOMER":-2}	"transcriptional antiterminator BglG"	
"CPLX0-2881_RXN"	{"CPLX0-2881":1,"EG10542-MONOMER":-6}	"Lon protease"	
"CPLX0-2901_RXN"	{"CPLX0-2901":1,"MONOMER0-1842":-4,"MONOMER0-1843":-4}	"aspartate 1-decarboxylase"	
"CPLX0-2921_RXN"	{"CPLX0-2921":1,"EG10463-MONOMER":-12}	"periplasmic serine endoprotease DegP"	
"CPLX0-2941_RXN"	{"CPLX0-2941":1,"EG10968-MONOMER":-4}	"protease IV, a signal peptide peptidase"	
"CPLX0-2982_RXN"	{"CPLX0-2982":1,"CPLX0-1321":-6,"EG11506-MONOMER":-6}	"FtsH/HflKC protease complex"	
"CPLX0-3001_RXN"	{"CPLX0-3001":1,"EG10695-MONOMER":-2}	"peptidase D"	
"CPLX0-301_RXN"	{"CPLX0-301":1,"EG11396-MONOMER":-6}	null	
"CPLX0-3021_RXN"	{"CPLX0-3021":1,"G7925-MONOMER":-8}	"isoaspartyl dipeptidase"	
"CPLX0-303_RXN"	{"CPLX0-303":1,"EG11517-MONOMER":-2}	"fructose-1,6-bisphosphatase 2"	
"CPLX0-3041_RXN"	{"CPLX0-3041":1,"EG11549-MONOMER":-2}	"peptidase T"	
"CPLX0-3061_RXN"	{"CPLX0-3061":1,"EG10694-MONOMER":-6}	"aminopeptidase A/I and DNA-binding transcriptional repressor"	
"CPLX0-3081_RXN"	{"CPLX0-3081":1,"EG10697-MONOMER":-4}	"Xaa-Pro aminopeptidase"	
"CPLX0-3101_RXN"	{"CPLX0-3101":1,"EG10158-MONOMER":-14}	"ClpP serine protease"	
"CPLX0-3102_RXN"	{"CPLX0-3102":1,"EG10159-MONOMER":-6}	"ClpX ATP-dependent protease specificity component and chaperone"	
"CPLX0-3104_RXN"	{"CPLX0-3104":1,"CPLX0-3101":-1,"CPLX0-881":-2}	"ClpAP"	
"CPLX0-3107_RXN"	{"CPLX0-3107":1,"CPLX0-3101":-1,"CPLX0-3102":-2}	"ClpXP"	
"CPLX0-3108_RXN"	{"CPLX0-3108":1,"CPLX0-3101":-1,"CPLX0-881":-1,"CPLX0-3102":-1}	"ClpAXP"	
"CPLX0-3121_RXN"	{"CPLX0-3121":1,"EG11723-MONOMER":-2}	"chromate reductase"	
"CPLX0-3141_RXN"	{"CPLX0-3141":1,"EG12657-MONOMER":-2}	"putative quinol monooxygenase YgiN"	
"CPLX0-3161_RXN"	{"CPLX0-3161":1,"MONOMER0-1981":-2}	null	
"CPLX0-3181_RXN"	{"CPLX0-3181":1,"MONOMER0-2001":-2}	null	
"CPLX0-3201_RXN"	{"CPLX0-3201":1,"EG10580-MONOMER":-2}	"peptidoglycan DD-endopeptidase/peptidoglycan LD-endopeptidase"	
"CPLX0-321_RXN"	{"CPLX0-321":1,"PDXJ-MONOMER":-8}	null	
"CPLX0-3221_RXN"	{"CPLX0-3221":1,"YRAO-MONOMER":-4}	"DnaA initiator-associating factor for replication initiation"	
"CPLX0-322_RXN"	{"CPLX0-322":1,"GSK-MONOMER":-2}	"inosine/guanosine kinase"	
"CPLX0-3241_RXN"	{"CPLX0-3241":1,"NAPG-MONOMER":-1,"NAPH-MONOMER":-1}	"ubiquinol&mdash;[NapC cytochrome <i>c</i>] reductase NapGH"	
"CPLX0-3281_RXN"	{"CPLX0-3281":1,"EG10857-MONOMER":-2}	"RNase III"	
"CPLX0-3301_RXN"	{"CPLX0-3301":1,"EG11111-MONOMER":-2}	"DNA replication inhibitor CspD"	
"CPLX0-3361_RXN"	{"CPLX0-3361":1,"NUOB-MONOMER":-1,"NUOC-MONOMER":-1,"NUOE-MONOMER":-1,"NUOF-MONOMER":-1,"NUOG-MONOMER":-1,"NUOI-MONOMER":-1}	"NADH:quinone oxidoreductase I, peripheral arm"	
"CPLX0-3382_RXN"	{"CPLX0-3382":1,"G7702-MONOMER":null,"G7703-MONOMER":null,"G7704-MONOMER":null,"G7705-MONOMER":null,"G7706-MONOMER":null,"G7707-MONOMER":null,"G7708-MONOMER":null,"G7709-MONOMER":null,"G7710-MONOMER":null,"G7711-MONOMER":null,"EG12173-MONOMER":null,"EG11359-MONOMER":null}	"Type II secretion system"	
"CPLX0-3401_RXN"	{"CPLX0-3401":1,"EG10308-MONOMER":null,"EG10313-MONOMER":null,"EG10314-MONOMER":null,"EG10315-MONOMER":null}	"fimbrial complex"	
"CPLX0-341_RXN"	{"CPLX0-341":1,"EG10004-MONOMER":-12}	"fused 4'-phosphopantothenoylcysteine decarboxylase and phosphopantothenoylcysteine synthetase"	
"CPLX0-3461_RXN"	{"CPLX0-3461":1,"EG10859-MONOMER":-4}	"ribonuclease E"	
"CPLX0-3482_RXN"	{"CPLX0-3482":1,"ALDDEHYDROGB-MONOMER":-4}	"aldehyde dehydrogenase B"	
"CPLX0-3501_RXN"	{"CPLX0-3501":1,"G7452-MONOMER":-2}	"7-cyano-7-deazaguanine reductase"	
"CPLX0-3521_RXN"	{"CPLX0-3521":1,"EG10743-MONOMER":-3}	"polynucleotide phosphorylase"	
"CPLX0-3541_RXN"	{"CPLX0-3541":1,"EG10844-MONOMER":-2}	"ATP-dependent RNA helicase RhlB"	
"CPLX0-3561_RXN"	{"CPLX0-3561":1,"EG10484-MONOMER":-2}	"hydrogenase isozymes nickel incorporation protein HypB"	
"CPLX0-3581_RXN"	{"CPLX0-3581":1,"EG11852-MONOMER":-2}	"D-aminoacyl-tRNA deacylase"	
"CPLX0-3601_RXN"	{"CPLX0-3601":1,"G7175-MONOMER":-2}	"ribonuclease BN"	
"CPLX0-3602_RXN"	{"CPLX0-3602":1,"EG11547-MONOMER":-2}	"RNase T"	
"CPLX0-3621_RXN"	{"CPLX0-3621":1,"EG10236-MONOMER":-6}	"replicative DNA helicase"	
"CPLX0-3641_RXN"	{"CPLX0-3641":1,"G6755-MONOMER":-4}	"&gamma;-aminobutyraldehyde dehydrogenase"	
"CPLX0-3661_RXN"	{"CPLX0-3661":1,"G7590-MONOMER":-2}	"fused heptose 7-phosphate kinase/heptose 1-phosphate adenyltransferase"	
"CPLX0-3681_RXN"	{"CPLX0-3681":1,"EG10838-MONOMER":-5}	null	
"CPLX0-3721_RXN"	{"CPLX0-3721":1,"EG12633-MONOMER":-2}	"ADP-sugar pyrophosphatase"	
"CPLX0-3741_RXN"	{"CPLX0-3741":1,"GLUTRNAREDUCT-MONOMER":-2}	null	
"CPLX0-3761_RXN"	{"CPLX0-3761":1,"EG10242-MONOMER":-2}	"&beta; sliding clamp"	
"CPLX0-3781_RXN"	{"CPLX0-3781":1,"MONOMER0-1041":-1,"EG12844-MONOMER":-2}	"YefM-YoeB antitoxin/toxin complex / DNA-binding transcriptional repressor"	
"CPLX0-3801_RXN"	{"CPLX0-3801":1,"EG10245-MONOMER":-3,"EG11500-MONOMER":-1,"EG11412-MONOMER":-1}	"DNA polymerase III, preinitiation complex"	
"CPLX0-3802_RXN"	{"CPLX0-3802":1,"EG10245-MONOMER":-2}	"DNA polymerase III, &tau; subunit dimer"	
"CPLX0-3803_RXN"	{"CPLX0-3803":1,"CPLX0-2361":-3,"CPLX0-3801":-1,"CPLX0-3761":-2,"CPLX0-3802":-1,"CPLX0-7910":-4}	"DNA polymerase III, holoenzyme"	
"CPLX0-3821_RXN"	{"CPLX0-3821":1,"EG10483-MONOMER":null,"EG10484-MONOMER":null}	"HypA-HypB heterodimer"	
"CPLX0-3841_RXN"	{"CPLX0-3841":1,"EG11294-MONOMER":-2}	null	
"CPLX0-3861_RXN"	{"CPLX0-3861":1,"G7724-MONOMER":-8}	null	
"CPLX0-3881_RXN"	{"CPLX0-3881":1,"FCL-MONOMER":-2}	null	
"CPLX0-3901_RXN"	{"CPLX0-3901":1,"EG11685-MONOMER":-6}	"&alpha;-D-xyloside xylohydrolase"	
"CPLX0-3921_RXN"	{"CPLX0-3921":1,"G6500-MONOMER":-3}	"heat shock protein HspQ"	
"CPLX0-3922_RXN"	{"CPLX0-3922":1,"CPLX0-3621":null,"CPLX0-0":null,"CPLX0-3":null,"EG10763-MONOMER":null,"EG10765-MONOMER":null,"EG10239-MONOMER":null}	"primosome"	
"CPLX0-3923_RXN"	{"CPLX0-3923":1,"G6895-MONOMER":-2}	"putative monooxygenase YdhR"	
"CPLX0-3924_RXN"	{"CPLX0-3924":1,"G7865-MONOMER":-2}	"peptidyl-prolyl <i>cis-trans</i> isomerase FklB"	
"CPLX0-3925_RXN"	{"CPLX0-3925":1,"EG11056-MONOMER":-1,"EG11057-MONOMER":-2}	"DNA polymerase V"	
"CPLX0-3927_RXN"	{"CPLX0-3927":1,"EG11731-MONOMER":-6}	"regulatory ATPase RavA"	
"CPLX0-3929_RXN"	{"CPLX0-3929":1,"EG10973-MONOMER":-4}	"D-arabinose 5-phosphate isomerase GutQ"	
"CPLX0-3930_RXN"	{"CPLX0-3930":1,"EG10320-MONOMER":-4,"MONOMER0-2488":-2}	"FlhDC DNA-binding transcriptional dual regulator"	
"CPLX0-3931_RXN"	{"CPLX0-3931":1,"EG10837-MONOMER":-2}	"ATP-dependent DNA helicase Rep"	
"CPLX0-3932_RXN"	{"CPLX0-3932":1,"CPLX0-7964":-1,"ACRD-MONOMER":-3,"EG11703-MONOMER":-6}	"multidrug efflux pump AcrAD-TolC"	
"CPLX0-3933_RXN"	{"CPLX0-3933":1,"EG10952-MONOMER":-1,"EG10658-MONOMER":-1,"G7352-MONOMER":-1,"G6093-MONOMER":-1,"G7320-MONOMER":-1}	"Outer Membrane Protein Assembly Complex"	
"CPLX0-3934_RXN"	{"CPLX0-3934":1,"EG10599-MONOMER":-14,"EG10600-MONOMER":-14}	"GroEL-GroES chaperonin complex"	
"CPLX0-3936_RXN"	{"CPLX0-3936":1,"H2NEOPTERINALDOL-MONOMER":-8}	"dihydroneopterin aldolase"	
"CPLX0-3937_RXN"	{"CPLX0-3937":1,"EG10252-MONOMER":-4,"EG10253-MONOMER":-4}	"evolved &beta;-D-galactosidase"	
"CPLX0-3938_RXN"	{"CPLX0-3938":1,"EG12177-MONOMER":-3}	"copper binding protein CutA"	
"CPLX0-3939_RXN"	{"CPLX0-3939":1,"G6334-MONOMER":-2}	"universal stress protein G"	
"CPLX0-3941_RXN"	{"CPLX0-3941":1,"G6717-MONOMER":-4}	"phenylacetyl-CoA thioesterase"	
"CPLX0-3943_RXN"	{"CPLX0-3943":1,"G6645-MONOMER":-2}	null	
"CPLX0-3948_RXN"	{"CPLX0-3948":1,"EG12600-MONOMER":-2}	null	
"CPLX0-3949_RXN"	{"CPLX0-3949":1,"THIG-MONOMER":-6,"THIH-MONOMER":-6}	"thiazole synthase"	
"CPLX0-3950_RXN"	{"CPLX0-3950":1,"EG11023-MONOMER":-2}	"tRNA m<sup>1</sup>G37 methyltransferase"	
"CPLX0-3951_RXN"	{"CPLX0-3951":1,"EG10605-MONOMER":-2}	"peptidoglycan glycosyltransferase / peptidoglycan DD-transpeptidase MrcB"	
"CPLX0-3952_RXN"	{"CPLX0-3952":1,"RIBOFLAVIN-SYN-MONOMER":-3}	null	
"CPLX0-3954_RXN"	{"CPLX0-3954":1,"EG12026-MONOMER":-4}	null	
"CPLX0-3955_RXN"	{"CPLX0-3955":1,"EG10873-MONOMER":-2}	"50S ribosomal subunit protein L7/L12 dimer"	
"CPLX0-3956_RXN"	{"CPLX0-3956":1,"EG10871-MONOMER":-1,"CPLX0-3955":-2}	"50S ribosomal protein complex L8"	
"CPLX0-3957_RXN"	{"CPLX0-3957":1,"EG10927-MONOMER":-2,"EG11094-MONOMER":-2}	"ATP-dependent structure-specific DNA nuclease"	
"CPLX0-3958_RXN"	{"CPLX0-3958":1,"EG10458-MONOMER":-2,"EG10459-MONOMER":-2,"EG10460-MONOMER":-1}	"<I>Eco</I>KI restriction-modification system"	
"CPLX0-3959_RXN"	{"CPLX0-3959":1,"EG11069-MONOMER":null,"EG11071-MONOMER":null}	"Xer site-specific recombination system"	
"CPLX0-3961_RXN"	{"CPLX0-3961":1,"G7058-MONOMER":-4}	"hydroxyisourate hydrolase / transthyretin-related protein"	
"CPLX0-3969_RXN"	{"CPLX0-3969":1,"EG10921-MONOMER":-24}	"ferritin iron-storage complex"	
"CPLX0-3970_RXN"	{"CPLX0-3970":1,"OPPB-MONOMER":-1,"OPPC-MONOMER":-1,"OPPD-MONOMER":-1,"OPPF-MONOMER":-1,"G6665-MONOMER":-1}	"murein tripeptide ABC transporter"	
"CPLX0-3971_RXN"	{"CPLX0-3971":1,"EG12410-MONOMER":-2}	"GDP-mannose hydrolase"	
"CPLX0-3976_RXN"	{"CPLX0-3976":1,"EG11486-MONOMER":null,"FUC4NACTRANS-MONOMER":null,"EG11295-MONOMER":null}	"Enterobacterial Common Antigen Biosynthesis Protein Complex"	
"CPLX0-3_RXN"	{"CPLX0-3":1,"EG10764-MONOMER":-2}	"primosomal replication protein N"	
"CPLX0-4_RXN"	{"CPLX0-4":1,"G7686-MONOMER":null,"G7685-MONOMER":null}	"aromatic carboxylic acid efflux pump"	
"CPLX0-661_RXN"	{"CPLX0-661":1,"EG11241-MONOMER":-8}	"putative hydrolase YcaC"	
"CPLX0-682_RXN"	{"CPLX0-682":1,"MONOMER0-541":-6}	null	
"CPLX0-721_RXN"	{"CPLX0-721":1,"EG11816-MONOMER":-3}	null	
"CPLX0-7415_RXN"	{"CPLX0-7415":1,"LIPIDADISACCHARIDESYNTH-MONOMER":-2}	"lipid A disaccharide synthase"	
"CPLX0-7417_RXN"	{"CPLX0-7417":1,"G6212-MONOMER":-2}	"IS2 insertion element repressor InsA"	
"CPLX0-7418_RXN"	{"CPLX0-7418":1,"EG10603-MONOMER":-2}	"DNA-binding transcriptional repressor MprA"	
"CPLX0-7420_RXN"	{"CPLX0-7420":1,"G7327-MONOMER":-2}	"tRNA Cm32/Um32 methyltransferase"	
"CPLX0-7421_RXN"	{"CPLX0-7421":1,"EG11888-MONOMER":-2}	"tRNA (cytidine/uridine-2'-<i>O</i>)-ribose methyltransferase"	
"CPLX0-7422_RXN"	{"CPLX0-7422":1,"EG12309-MONOMER":-2}	"predicted rRNA methyltransferase"	
"CPLX0-7423_RXN"	{"CPLX0-7423":1,"EG11254-MONOMER":-2}	"23S rRNA m<sup>3</sup>&Psi;1915 methyltransferase"	
"CPLX0-7425_RXN"	{"CPLX0-7425":1,"CPLX0-7757":-1,"EG10443-MONOMER":-1}	"HipAB toxin/antitoxin complex / DNA-binding transcriptional repressor"	
"CPLX0-7426_RXN"	{"CPLX0-7426":1,"OPPSYN-MONOMER":-2}	"<i>all-trans</i>-octaprenyl-diphosphate synthase"	
"CPLX0-743_RXN"	{"CPLX0-743":1,"DXS-MONOMER":-2}	null	
"CPLX0-7444_RXN"	{"CPLX0-7444":1,"EG11126-MONOMER":-2}	"DUF892 domain-containing protein YciF"	
"CPLX0-7450_RXN"	{"CPLX0-7450":1,"FLIG-FLAGELLAR-SWITCH-PROTEIN":-26,"FLIM-FLAGELLAR-C-RING-SWITCH":-34,"FLIN-FLAGELLAR-C-RING-SWITCH":null}	"flagellar motor switch complex"	
"CPLX0-7451_RXN"	{"CPLX0-7451":1,"G370-MONOMER":null,"G7028-MONOMER":null,"EG11224-MONOMER":null,"EG11975-MONOMER":null,"EG11976-MONOMER":null,"EG11977-MONOMER":null,"EG11656-MONOMER":-12,"G377-MONOMER":-6,"G378-MONOMER":null}	"flagellar export apparatus"	
"CPLX0-7452_RXN"	{"CPLX0-7452":1,"FLAGELLAR-MOTOR-COMPLEX":null,"G361-MONOMER":-120,"EG11967-MONOMER":null,"EG11545-MONOMER":null,"EG10321-MONOMER":null,"EG10841-MONOMER":-5}	"flagellum"	
"CPLX0-7458_RXN"	{"CPLX0-7458":1,"G7545-MONOMER":null,"G7544-MONOMER":null,"MONOMER0-561":null}	"glycolate dehydrogenase"	
"CPLX0-7462_RXN"	{"CPLX0-7462":1,"EG11234-MONOMER":-2}	null	
"CPLX0-7465_RXN"	{"CPLX0-7465":1,"ALARACECAT-MONOMER":-2}	"alanine racemase 2"	
"CPLX0-7466_RXN"	{"CPLX0-7466":1,"XYLULOKIN-MONOMER":-2}	"xylulokinase"	
"CPLX0-7521_RXN"	{"CPLX0-7521":1,"EG12319-MONOMER":-4}	"carbonic anhydrase 2"	
"CPLX0-7525_RXN"	{"CPLX0-7525":1,"MEND-MONOMER":-2}	"2-succinyl-5-enolpyruvyl-6-hydroxy-3-cyclohexene-1-carboxylate synthase"	
"CPLX0-7529_RXN"	{"CPLX0-7529":1,"G7107-MONOMER":-8,"G7105-MONOMER":-4}	"polysaccharide export complex"	
"CPLX0-7530_RXN"	{"CPLX0-7530":1,"MONOMER0-282":-3}	"outer membrane porin PhoE"	
"CPLX0-7532_RXN"	{"CPLX0-7532":1,"AMTB-MONOMER":-3}	"ammonium transporter"	
"CPLX0-7533_RXN"	{"CPLX0-7533":1,"EG10670-MONOMER":-3}	"outer membrane porin C"	
"CPLX0-7534_RXN"	{"CPLX0-7534":1,"EG10671-MONOMER":-3}	"outer membrane porin F"	
"CPLX0-7535_RXN"	{"CPLX0-7535":1,"YJDE-MONOMER":-2}	"arginine:agmatine antiporter"	
"CPLX0-7536_RXN"	{"CPLX0-7536":1,"EG11663-MONOMER":-2}	"FKBP-type peptidyl-prolyl <i>cis-trans</I> isomerase SlyD"	
"CPLX0-7538_RXN"	{"CPLX0-7538":1,"EG12878-MONOMER":-4}	"cell division protein ZapA"	
"CPLX0-7561_RXN"	{"CPLX0-7561":1,"EG12096-MONOMER":null,"EG11250-MONOMER":null}	"ChpB-ChpS complex"	
"CPLX0-7564_RXN"	{"CPLX0-7564":1,"EG11081-MONOMER":-2}	"1-hydroxy-2-methyl-2-(E)-butenyl 4-diphosphate reductase"	
"CPLX0-7597_RXN"	{"CPLX0-7597":1,"EG10375-MONOMER":-2}	"5-carboxymethylaminomethyluridine-tRNA synthase subunit MnmG"	
"CPLX0-7608_RXN"	{"CPLX0-7608":1,"EG10997-MONOMER":-2}	"5-carboxymethylaminomethyluridine-tRNA synthase GTPase subunit"	
"CPLX0-7609_RXN"	{"CPLX0-7609":1,"CPLX0-7608":-1,"CPLX0-7597":-1}	null	
"CPLX0-7610_RXN"	{"CPLX0-7610":1,"G7632-MONOMER":null,"G7633-MONOMER":null}	"<I>N</I>-acetyl-D-galactosamine specific PTS (cryptic)"	
"CPLX0-7613_RXN"	{"CPLX0-7613":1,"G7286-MONOMER":-6}	"putative ethanolamine catabolic microcompartment shell protein EutN"	
"CPLX0-7614_RXN"	{"CPLX0-7614":1,"ATPPHOSRIBOSTRANS-MONOMER":-2}	"ATP phosphoribosyltransferase"	
"CPLX0-7615_RXN"	{"CPLX0-7615":1,"KDGALDOL-MONOMER":-6}	null	
"CPLX0-7616_RXN"	{"CPLX0-7616":1,"G6278-MONOMER":-4}	"tartronate semialdehyde reductase 2"	
"CPLX0-7617_RXN"	{"CPLX0-7617":1,"EG12332-MONOMER":-2}	"iron-sulfur cluster insertion protein ErpA"	
"CPLX0-761_RXN"	{"CPLX0-761":1,"G7485-MONOMER":null,"G7486-MONOMER":null,"G7487-MONOMER":null}	"putative xanthine dehydrogenase"	
"CPLX0-7622_RXN"	{"CPLX0-7622":1,"LSERINEDEAM3-MONOMER":-2}	"L-serine deaminase III"	
"CPLX0-7623_RXN"	{"CPLX0-7623":1,"G6606-MONOMER":-2}	"putative two-component system connector protein AriR"	
"CPLX0-7624_RXN"	{"CPLX0-7624":1,"EG10955-MONOMER":-2,"G7629-MONOMER":-4}	"YhaV-PrlF toxin-antitoxin complex"	
"CPLX0-7625_RXN"	{"CPLX0-7625":1,"G7185-MONOMER":-2}	"dCMP phosphohydrolase"	
"CPLX0-7626_RXN"	{"CPLX0-7626":1,"EG11160-MONOMER":-7}	"small conductance mechanosensitive channel MscS"	
"CPLX0-7627_RXN"	{"CPLX0-7627":1,"EG11180-MONOMER":-5}	"large conductance mechanosensitive channel"	
"CPLX0-7628_RXN"	{"CPLX0-7628":1,"EG11569-MONOMER":-1,"EG10855-MONOMER":-1}	"lipopolysaccharide transport system - outer membrane assembly complex"	
"CPLX0-7629_RXN"	{"CPLX0-7629":1,"NHAA-MONOMER":-2}	"Na<sup>+</sup>:H<sup>+</sup> antiporter NhaA"	
"CPLX0-7630_RXN"	{"CPLX0-7630":1,"THIOESTERI-MONOMER":-4}	"multifunctional acyl-CoA thioesterase I and protease I and lysophospholipase L1"	
"CPLX0-7631_RXN"	{"CPLX0-7631":1,"FUCISOM-MONOMER":-6}	"L-fucose isomerase"	
"CPLX0-7632_RXN"	{"CPLX0-7632":1,"PD01343":-4}	"NAD(P)H:quinone oxidoreductase"	
"CPLX0-7633_RXN"	{"CPLX0-7633":1,"FUCPALDOL-MONOMER":-4}	"L-fuculose-phosphate aldolase"	
"CPLX0-7641_RXN"	{"CPLX0-7641":1,"YIIP-MONOMER":-2}	"Zn<sup>2+</sup>/Fe<sup>2+</sup>/Cd<sup>2+</sup> exporter"	
"CPLX0-7642_RXN"	{"CPLX0-7642":1,"PROP-MONOMER":-2}	"osmolyte:H<sup>+</sup> symporter ProP"	
"CPLX0-7643_RXN"	{"CPLX0-7643":1,"KETOLREDUCTOISOM-MONOMER":-4}	"ketol-acid reductoisomerase (NADP<sup>+</sup>)"	
"CPLX0-7645_RXN"	{"CPLX0-7645":1,"EG10355-MONOMER":-10}	"L-fucose mutarotase"	
"CPLX0-7646_RXN"	{"CPLX0-7646":1,"EG10817-MONOMER":-10}	"D-ribose pyranase"	
"CPLX0-7647_RXN"	{"CPLX0-7647":1,"RIBOKIN-MONOMER":-2}	"ribokinase"	
"CPLX0-7648_RXN"	{"CPLX0-7648":1,"G7348-MONOMER":-2}	"anti-sigma factor stabilizing protein RseB"	
"CPLX0-7649_RXN"	{"CPLX0-7649":1,"EG11865-MONOMER":-2}	"L-rhamnose mutarotase"	
"CPLX0-7652_RXN"	{"CPLX0-7652":1,"RHAMNISOM-MONOMER":-4}	"L-rhamnose isomerase"	
"CPLX0-7653_RXN"	{"CPLX0-7653":1,"AQPZ-MONOMER":-4}	null	
"CPLX0-7654_RXN"	{"CPLX0-7654":1,"GLPF-MONOMER":-4}	"glycerol facilitator"	
"CPLX0-7655_RXN"	{"CPLX0-7655":1,"EG10528-MONOMER":-3}	"maltose outer membrane channel / phage lambda receptor protein"	
"CPLX0-7658_RXN"	{"CPLX0-7658":1,"G7920-MONOMER":-2}	"<i>N</i>-acetylneuraminate mutarotase"	
"CPLX0-7659_RXN"	{"CPLX0-7659":1,"RIBOFLAVINSYNDEAM-MONOMER":-2}	"fused diaminohydroxyphosphoribosylaminopyrimidine deaminase / 5-amino-6-(5-phosphoribosylamino)uracil reductase"	
"CPLX0-7660_RXN"	{"CPLX0-7660":1,"G6106-MONOMER":-4}	null	
"CPLX0-7662_RXN"	{"CPLX0-7662":1,"BETA-GLUCURONID-MONOMER":-4}	null	
"CPLX0-7666_RXN"	{"CPLX0-7666":1,"G6088-MONOMER":-2}	"DNA-binding transcriptional activator CaiF"	
"CPLX0-7667_RXN"	{"CPLX0-7667":1,"G7564-MONOMER":-2}	"NADPH-dependent aldehyde reductase YqhD"	
"CPLX0-7668_RXN"	{"CPLX0-7668":1,"EG11134-MONOMER":-2}	"putative oxidoreductase YdjA"	
"CPLX0-7669_RXN"	{"CPLX0-7669":1,"EG10490-MONOMER":-2}	"DNA-binding transcriptional dual regulator ArgP"	
"CPLX0-7672_RXN"	{"CPLX0-7672":1,"CPLX0-7701":-2}	"MntR-Mn<sup>2+</sup> DNA-binding transcriptional dual regulator"	
"CPLX0-7674_RXN"	{"CPLX0-7674":1,"KCH-MONOMER":-4}	"voltage-gated K<sup>+</sup> channel"	
"CPLX0-7675_RXN"	{"CPLX0-7675":1,"G6988-MONOMER":-3}	"2Fe-2S cluster-containing protein YeaW"	
"CPLX0-7678_RXN"	{"CPLX0-7678":1,"CPLX0-7677":-2}	"ZntR-Zn<sup>2+</sup> DNA-binding transcriptional activator"	
"CPLX0-7679_RXN"	{"CPLX0-7679":1,"EG11929-MONOMER":-2}	"DNA-binding transcriptional repressor Zur"	
"CPLX0-7682_RXN"	{"CPLX0-7682":1,"G7748-MONOMER":-2}	"iron-sulfur cluster carrier protein NfuA"	
"CPLX0-7683_RXN"	{"CPLX0-7683":1,"EG11845-MONOMER":-6}	"sulfoquinovose isomerase"	
"CPLX0-7684_RXN"	{"CPLX0-7684":1,"G7405-MONOMER":null,"G7406-MONOMER":null}	"L-valine exporter"	
"CPLX0-7685_RXN"	{"CPLX0-7685":1,"HYPOXANPRIBOSYLTRAN-MONOMER":-4}	"hypoxanthine phosphoribosyltransferase"	
"CPLX0-7686_RXN"	{"CPLX0-7686":1,"EG11878-MONOMER":-2}	"cell division factor ZapB"	
"CPLX0-7687_RXN"	{"CPLX0-7687":1,"G6811-MONOMER":-2}	"succinate semialdehyde dehydrogenase (NAD(P)<sup>+</sup>) Sad"	
"CPLX0-7688_RXN"	{"CPLX0-7688":1,"SUCCSEMIALDDEHYDROG-MONOMER":-4}	"succinate-semialdehyde dehydrogenase (NADP<sup>+</sup>) GabD"	
"CPLX0-7691_RXN"	{"CPLX0-7691":1,"EG11811-MONOMER":-4}	"isovaleryl-CoA dehydrogenase and DNA-binding transcriptional repressor"	
"CPLX0-7692_RXN"	{"CPLX0-7692":1,"EG10572-MONOMER":-2}	"nucleoside triphosphate pyrophosphohydrolase"	
"CPLX0-7693_RXN"	{"CPLX0-7693":1,"G6731-MONOMER":-2}	"FMN dependent NADH:quinone oxidoreductase"	
"CPLX0-7694_RXN"	{"CPLX0-7694":1,"G6261-MONOMER":-4}	"glutaminase 1"	
"CPLX0-7695_RXN"	{"CPLX0-7695":1,"G6810-MONOMER":-2}	"glutaminase 2"	
"CPLX0-7696_RXN"	{"CPLX0-7696":1,"EG10618-MONOMER":-2}	"chromosome partitioning protein MukB"	
"CPLX0-7697_RXN"	{"CPLX0-7697":1,"EG11252-MONOMER":-4,"CPLX0-7698":-1}	"MukEF complex"	
"CPLX0-7698_RXN"	{"CPLX0-7698":1,"EG12165-MONOMER":-2}	"MukF dimer"	
"CPLX0-7704_RXN"	{"CPLX0-7704":1,"EG10613-MONOMER":-2}	"ATP-dependent Lipid A-core flippase"	
"CPLX0-7705_RXN"	{"CPLX0-7705":1,"PD00196":-2}	"DNA-binding transcriptional dual regulator Fis"	
"CPLX0-7707_RXN"	{"CPLX0-7707":1,"MONOMER0-1781":-4}	"NikR-Ni DNA-binding transcriptional repressor"	
"CPLX0-7708_RXN"	{"CPLX0-7708":1,"CPLX0-7702":-2}	"DNA-binding transcriptional dual regulator CueR-Cu<sup>+</sup>"	
"CPLX0-7709_RXN"	{"CPLX0-7709":1,"G6644-MONOMER":-12}	null	
"CPLX0-7710_RXN"	{"CPLX0-7710":1,"PD00364":-2}	"DNA-binding transcriptional repressor MarR"	
"CPLX0-7711_RXN"	{"CPLX0-7711":1,"EG10455-MONOMER":-3}	"periplasmic chaperone Skp"	
"CPLX0-7712_RXN"	{"CPLX0-7712":1,"GDPMANMANHYDRO-MONOMER":-2}	"GDP-mannose mannosyl hydrolase"	
"CPLX0-7713_RXN"	{"CPLX0-7713":1,"PD00297":-2}	"DNA-binding transcriptional dual regulator DsdC"	
"CPLX0-7717_RXN"	{"CPLX0-7717":1,"EG10748-MONOMER":-2}	"peptidoglycan glycosyltransferase / peptidoglycan DD-transpeptidase MrcA"	
"CPLX0-7718_RXN"	{"CPLX0-7718":1,"G7168-MONOMER":-6}	"UDP-4-amino-4-deoxy-L-arabinose formyltransferase/UDP-glucuronate dehydrogenase"	
"CPLX0-7719_RXN"	{"CPLX0-7719":1,"QUINOLINATE-SYNTHA-MONOMER":-2}	null	
"CPLX0-7720_RXN"	{"CPLX0-7720":1,"MONOMER0-2682":null,"G7171-MONOMER":null}	null	
"CPLX0-7721_RXN"	{"CPLX0-7721":1,"PHOSPHO-DCUR-MONOMER":-2}	"DcuR-Phosphorylated DNA-binding transcriptional activator"	
"CPLX0-7722_RXN"	{"CPLX0-7722":1,"G7160-MONOMER":-8}	null	
"CPLX0-7723_RXN"	{"CPLX0-7723":1,"G7158-MONOMER":-6}	null	
"CPLX0-7724_RXN"	{"CPLX0-7724":1,"EG10284-MONOMER":-2}	"formate dehydrogenase formation protein"	
"CPLX0-7725_RXN"	{"CPLX0-7725":1,"G7430-MONOMER":-1,"G7429-MONOMER":-2,"G7428-MONOMER":-6,"G7427-MONOMER":-1,"G7426-MONOMER":-1}	"CRISPR-associated complex for antiviral defense"	
"CPLX0-7726_RXN"	{"CPLX0-7726":1,"G6501-MONOMER":-2}	"23S rRNA m<sup>5</sup>C1962 methyltransferase"	
"CPLX0-7727_RXN"	{"CPLX0-7727":1,"EG12366-MONOMER":-2}	"16S rRNA m<sup>3</sup>U1498 methyltransferase"	
"CPLX0-7728_RXN"	{"CPLX0-7728":1,"EG10454-MONOMER":-2}	"tRNA pseudouridine<sup>38-40</sup> synthase"	
"CPLX0-7731_RXN"	{"CPLX0-7731":1,"G6720-MONOMER":-2}	"DNA-binding transcriptional repressor PaaX"	
"CPLX0-7732_RXN"	{"CPLX0-7732":1,"G7263-MONOMER":-2}	"<i>N</i>-acetylmuramic acid 6-phosphate etherase"	
"CPLX0-7733_RXN"	{"CPLX0-7733":1,"PD00250":-2}	"DNA-binding transcriptional dual regulator AsnC"	
"CPLX0-7734_RXN"	{"CPLX0-7734":1,"EG12235-MONOMER":-2}	"DNA-binding transcriptional repressor ArsR"	
"CPLX0-7740_RXN"	{"CPLX0-7740":1,"PD04028":-2}	"DNA-binding transcriptional repressor CytR"	
"CPLX0-7741_RXN"	{"CPLX0-7741":1,"METHYLMALONYL-COA-MUT-MONOMER":-2}	null	
"CPLX0-7744_RXN"	{"CPLX0-7744":1,"G7858-MONOMER":-2}	"3-keto-L-gulonate-6-phosphate decarboxylase UlaD"	
"CPLX0-7745_RXN"	{"CPLX0-7745":1,"G7262-MONOMER":-4}	"DNA-binding transcriptional dual regulator MurR"	
"CPLX0-7747_RXN"	{"CPLX0-7747":1,"G6660-MONOMER":-2}	"lipid hydroperoxide peroxidase"	
"CPLX0-7748_RXN"	{"CPLX0-7748":1,"PHOSPHO-CPXR":-2}	"CpxR-P<sup>asp</sup> DNA-binding transcriptional dual regulator"	
"CPLX0-7754_RXN"	{"CPLX0-7754":1,"PHOSPHO-UHPA":-2}	"UhpA-Phosphorylated DNA-binding transcriptional activator"	
"CPLX0-7755_RXN"	{"CPLX0-7755":1,"EG12172-MONOMER":-2}	null	
"CPLX0-7756_RXN"	{"CPLX0-7756":1,"EG11212-MONOMER":-2}	"DNA-binding transcriptional repressor NsrR"	
"CPLX0-7757_RXN"	{"CPLX0-7757":1,"EG10442-MONOMER":-2}	"HipB antitoxin / DNA-binding transcriptional repressor"	
"CPLX0-7758_RXN"	{"CPLX0-7758":1,"G6550-MONOMER":-2}	"2'-<i>O</i>-acetyl-ADP-ribose deacetylase, regulator of RNase III activity"	
"CPLX0-7759_RXN"	{"CPLX0-7759":1,"PD03938":-2}	"DNA-binding transcriptional dual regulator MetR"	
"CPLX0-7760_RXN"	{"CPLX0-7760":1,"ACONITASE-MONOMER":-2}	"aconitate hydratase A"	
"CPLX0-7766_RXN"	{"CPLX0-7766":1,"EG11105-MONOMER":-4}	"proofreading thioesterase in enterobactin biosynthesis"	
"CPLX0-7776_RXN"	{"CPLX0-7776":1,"EG11245-MONOMER":-2}	"fructose 1,6-bisphosphatase YggF"	
"CPLX0-7787_RXN"	{"CPLX0-7787":1,"G6109-MONOMER":-2,"G6110-MONOMER":-2}	"DinJ-YafQ antitoxin/toxin complex / DNA-binding transcriptional repressor"	
"CPLX0-7788_RXN"	{"CPLX0-7788":1,"G7145-MONOMER":-2,"EG11289-MONOMER":-2}	"NAD-dependent dihydropyrimidine dehydrogenase"	
"CPLX0-7789_RXN"	{"CPLX0-7789":1,"EG12855-MONOMER":-4}	"macrodomain Ter protein"	
"CPLX0-7791_RXN"	{"CPLX0-7791":1,"EG10836-MONOMER":-4,"EG11131-MONOMER":-4}	"RelB-RelE antitoxin/toxin complex / DNA-binding transcriptional repressor"	
"CPLX0-7794_RXN"	{"CPLX0-7794":1,"EG11847-MONOMER":-4}	"3-sulfolactaldehyde reductase"	
"CPLX0-7795_RXN"	{"CPLX0-7795":1,"PHOSPHO-KDPE":-2}	"KdpE-Phosphorylated DNA-binding transcriptional activator"	
"CPLX0-7796_RXN"	{"CPLX0-7796":1,"MONOMER0-157":-2}	"MetJ-S-adenosylmethionine DNA-binding transcriptional repressor"	
"CPLX0-7797_RXN"	{"CPLX0-7797":1,"PD00197":-2}	"DNA-binding transcriptional dual regulator FNR"	
"CPLX0-7801_RXN"	{"CPLX0-7801":1,"G7271-MONOMER":-3}	"predicted structural protein, ethanolamine utilization microcompartment"	
"CPLX0-7802_RXN"	{"CPLX0-7802":1,"EG11643-MONOMER":-2}	"diguanylate cyclase DgcZ"	
"CPLX0-7805_RXN"	{"CPLX0-7805":1,"G6157-MONOMER":-1,"G6156-MONOMER":-1,"G6155-MONOMER":-1}	null	
"CPLX0-7806_RXN"	{"CPLX0-7806":1,"G7194-MONOMER":-2}	"disulfide reductase"	
"CPLX0-7807_RXN"	{"CPLX0-7807":1,"EG11952-MONOMER":null,"YJCQ-MONOMER":null,"EG11954-MONOMER":null}	"putative multidrug efflux pump MdtNOP"	
"CPLX0-7808_RXN"	{"CPLX0-7808":1,"COPROGENOXI-MONOMER":-2}	null	
"CPLX0-7810_RXN"	{"CPLX0-7810":1,"EG11735-MONOMER":-2}	"heme-containing peroxidase/deferrochelatase"	
"CPLX0-7811_RXN"	{"CPLX0-7811":1,"PROTOPORGENOXI-MONOMER":-4}	"protoporphyrinogen oxidase"	
"CPLX0-7816_RXN"	{"CPLX0-7816":1,"EG11100-MONOMER":-2}	"putative nucleoid-associated protein YbaB"	
"CPLX0-7817_RXN"	{"CPLX0-7817":1,"EG12181-MONOMER":-2}	"glutaredoxin 4"	
"CPLX0-7819_RXN"	{"CPLX0-7819":1,"KEFC-MONOMER":-2}	null	
"CPLX0-7820_RXN"	{"CPLX0-7820":1,"G6804-MONOMER":-10}	"3-hydroxy-2,4-pentadione 5-phosphate thiolase"	
"CPLX0-7822_RXN"	{"CPLX0-7822":1,"G7571-MONOMER":-2,"G7572-MONOMER":-2}	"MqsA-MqsR antitoxin/toxin complex"	
"CPLX0-7823_RXN"	{"CPLX0-7823":1,"G6783-MONOMER":null,"G6784-MONOMER":null}	"DosC-DosP complex"	
"CPLX0-7824_RXN"	{"CPLX0-7824":1,"EG11378-MONOMER":-2}	"iron-sulfur cluster insertion protein SufA"	
"CPLX0-7826_RXN"	{"CPLX0-7826":1,"G7530-MONOMER":-2}	"dITP/XTP pyrophosphatase"	
"CPLX0-7827_RXN"	{"CPLX0-7827":1,"G6326-MONOMER":-2}	"carboxylate-amine ligase"	
"CPLX0-782_RXN"	{"CPLX0-782":1,"EG11306-MONOMER":-2}	"lipoyl synthase"	
"CPLX0-7835_RXN"	{"CPLX0-7835":1,"G7287-MONOMER":-6}	"putative ethanolamine catabolic microcompartment shell protein EutM"	
"CPLX0-7836_RXN"	{"CPLX0-7836":1,"G7292-MONOMER":-6}	"putative ethanolamine catabolic microcompartment shell protein EutS"	
"CPLX0-7837_RXN"	{"CPLX0-7837":1,"EG11132-MONOMER":-4}	"phosphoenolpyruvate synthetase regulatory protein"	
"CPLX0-7838_RXN"	{"CPLX0-7838":1,"G7454-MONOMER":-2}	"cysteine sulfinate desulfinase"	
"CPLX0-7839_RXN"	{"CPLX0-7839":1,"G7455-MONOMER":-2}	"sulfur acceptor protein CsdE"	
"CPLX0-7841_RXN"	{"CPLX0-7841":1,"ALPHACOMP-MONOMER":-8}	"sulfite reductase, flavoprotein subunit complex"	
"CPLX0-7843_RXN"	{"CPLX0-7843":1,"FOCA-MONOMER":-5}	"formate channel FocA"	
"CPLX0-7844_RXN"	{"CPLX0-7844":1,"G6669-MONOMER":-2,"G6670-MONOMER":-2}	"<i>p</i>-aminobenzoyl-glutamate hydrolase"	
"CPLX0-7847_RXN"	{"CPLX0-7847":1,"PDXA-MONOMER":-2}	null	
"CPLX0-7848_RXN"	{"CPLX0-7848":1,"G7855-MONOMER":-6}	null	
"CPLX0-7852_RXN"	{"CPLX0-7852":1,"RCSB-MONOMER":-1,"EG11544-MONOMER":-1}	"GadE-RcsB DNA-binding transcriptional activator"	
"CPLX0-7853_RXN"	{"CPLX0-7853":1,"EG11835-MONOMER":-2}	"Der GTPase-activating protein YihI"	
"CPLX0-7854_RXN"	{"CPLX0-7854":1,"EG12202-MONOMER":-2}	"DNA-binding transcriptional repressor TreR"	
"CPLX0-7870_RXN"	{"CPLX0-7870":1,"ATOS-MONOMER":-2}	"sensor histidine kinase AtoS"	
"CPLX0-7877_RXN"	{"CPLX0-7877":1,"PGLUCISOM":-2}	null	
"CPLX0-7878_RXN"	{"CPLX0-7878":1,"G7236-MONOMER":-4}	null	
"CPLX0-7879_RXN"	{"CPLX0-7879":1,"EG10909-MONOMER":-1,"EG10666-MONOMER":-1}	"NusB-S10 complex"	
"CPLX0-7882_RXN"	{"CPLX0-7882":1,"NAPHTHOATE-SYN-MONOMER":-6}	null	
"CPLX0-7885_RXN"	{"CPLX0-7885":1,"MONOMER0-4196":null,"MONOMER0-4195":null}	"glutathione hydrolase"	
"CPLX0-7887_RXN"	{"CPLX0-7887":1,"G7242-MONOMER":-2}	"glutamate&mdash;pyruvate aminotransferase AlaC"	
"CPLX0-7888_RXN"	{"CPLX0-7888":1,"G7184-MONOMER":-2}	"glutamate&mdash;pyruvate aminotransferase AlaA"	
"CPLX0-7889_RXN"	{"CPLX0-7889":1,"EG11211-MONOMER":-2}	"EF-P-lysine lysyltransferase"	
"CPLX0-7904_RXN"	{"CPLX0-7904":1,"EG12030-MONOMER":-4}	"pyrimidine-specific ribonucleoside hydrolase RihB"	
"CPLX0-7906_RXN"	{"CPLX0-7906":1,"CAIT-MONOMER":-3}	null	
"CPLX0-7908_RXN"	{"CPLX0-7908":1,"EG12132-MONOMER":-4}	"iron-sulfur cluster insertion protein IscA"	
"CPLX0-7909_RXN"	{"CPLX0-7909":1,"G7366-MONOMER":null,"G7365-MONOMER":null}	"RnlA-RnlB toxin-antitoxin complex"	
"CPLX0-7910_RXN"	{"CPLX0-7910":1,"EG11413-MONOMER":-1,"EG11414-MONOMER":-1}	"DNA polymerase III, &psi;-&chi; subunit"	
"CPLX0-7912_RXN"	{"CPLX0-7912":1,"G7288-MONOMER":-2}	"phosphate acetyltransferase EutD"	
"CPLX0-7913_RXN"	{"CPLX0-7913":1,"EG11884-MONOMER":-2}	"tellurite methyltransferase"	
"CPLX0-7914_RXN"	{"CPLX0-7914":1,"G7425-MONOMER":-2}	"multifunctional nuclease Cas1"	
"CPLX0-7916_RXN"	{"CPLX0-7916":1,"G7948-MONOMER":-1,"RCSB-MONOMER":-1}	"RcsB-BglJ DNA-binding transcriptional activator"	
"CPLX0-7917_RXN"	{"CPLX0-7917":1,"G7553-MONOMER":-2}	"disulfide reductase / organic hydroperoxide reductase"	
"CPLX0-7921_RXN"	{"CPLX0-7921":1,"MANX-MONOMER":-2}	"mannose-specific PTS enzyme IIAB component"	
"CPLX0-7922_RXN"	{"CPLX0-7922":1,"EG11191-MONOMER":-2}	"nucleoid occlusion factor SlmA"	
"CPLX0-7923_RXN"	{"CPLX0-7923":1,"G6939-MONOMER":-2}	"ATP-independent periplasmic chaperone"	
"CPLX0-7927_RXN"	{"CPLX0-7927":1,"G6760-MONOMER":-2}	"NADPH-dependent curcumin/dihydrocurcumin reductase"	
"CPLX0-7928_RXN"	{"CPLX0-7928":1,"EG10836-MONOMER":-4}	"Qin prophage; antitoxin/DNA-binding transcriptional repressor RelB"	
"CPLX0-7929_RXN"	{"CPLX0-7929":1,"EG12844-MONOMER":-2}	"antitoxin/DNA-binding transcriptional repressor YefM"	
"CPLX0-7932_RXN"	{"CPLX0-7932":1,"CYTDEAM-MONOMER":-6}	"cytosine/isoguanine deaminase"	
"CPLX0-7933_RXN"	{"CPLX0-7933":1,"G7489-MONOMER":-3}	"putative carbamoyltransferase YgeW"	
"CPLX0-7934_RXN"	{"CPLX0-7934":1,"EG10342-MONOMER":null,"G7424-MONOMER":null,"EG11086-MONOMER":null}	"FtsLBQ cell division complex"	
"CPLX0-7935_RXN"	{"CPLX0-7935":1,"EG10719-MONOMER":-2,"EG10718-MONOMER":-2,"EG10717-MONOMER":-2,"EG10716-MONOMER":-2}	"carbon-phosphorus lyase core complex"	
"CPLX0-7936_RXN"	{"CPLX0-7936":1,"EG10725-MONOMER":-2}	null	
"CPLX0-7938_RXN"	{"CPLX0-7938":1,"PTSI-MONOMER":-2}	"PTS enzyme I"	
"CPLX0-7939_RXN"	{"CPLX0-7939":1,"EG11568-MONOMER":-2}	"regulator of KefC-mediated potassium transport and quinone oxidoreductase"	
"CPLX0-7940_RXN"	{"CPLX0-7940":1,"G6140-MONOMER":-4}	"CP4-6 prophage; putative 2-dehydro-3-deoxygluconate aldolase"	
"CPLX0-7942_RXN"	{"CPLX0-7942":1,"EG10125-MONOMER":-1,"EG12181-MONOMER":-1}	"Grx4-BolA complex"	
"CPLX0-7944_RXN"	{"CPLX0-7944":1,"MONOMER0-341":-2}	"outer membrane phospholipase A"	
"CPLX0-7945_RXN"	{"CPLX0-7945":1,"G6540-MONOMER":-3}	"zinc-binding phosphatase YcdX"	
"CPLX0-7946_RXN"	{"CPLX0-7946":1,"EG10852-MONOMER":-4}	"ribosomal protein S6 modification protein"	
"CPLX0-7947_RXN"	{"CPLX0-7947":1,"SUCCARGDIHYDRO-MONOMER":-2}	"<i>N</i>-succinylarginine dihydrolase"	
"CPLX0-7950_RXN"	{"CPLX0-7950":1,"MHPCHYDROL-MONOMER":-2}	"2-hydroxy-6-oxononatrienedioate hydrolase"	
"CPLX0-7951_RXN"	{"CPLX0-7951":1,"MHPDHYDROL-MONOMER":-5}	"2-hydroxypentadienoate hydratase"	
"CPLX0-7952_RXN"	{"CPLX0-7952":1,"EG10306-MONOMER":-1,"CPLX0-1923":null}	"ferric coprogen outer membrane transport complex"	
"CPLX0-7955_RXN"	{"CPLX0-7955":1,"YJCG-MONOMER":-2}	"acetate/glycolate:cation symporter"	
"CPLX0-7956_RXN"	{"CPLX0-7956":1,"EG11447-MONOMER":-2}	"carbon storage regulator"	
"CPLX0-7957_RXN"	{"CPLX0-7957":1,"EG10943-MONOMER":-2}	"selenide, water dikinase"	
"CPLX0-7958_RXN"	{"CPLX0-7958":1,"PHNL-MONOMER":null,"EG10717-MONOMER":null,"EG10716-MONOMER":null,"EG10718-MONOMER":null}	"methylphosphonate degradation complex"	
"CPLX0-7959_RXN"	{"CPLX0-7959":1,"ASL-MONOMER":-4}	"adenylosuccinate lyase"	
"CPLX0-7960_RXN"	{"CPLX0-7960":1,"HMP-KIN-MONOMER":-2}	"protein/nucleic acid deglycase 3"	
"CPLX0-7961_RXN"	{"CPLX0-7961":1,"YADQ-MONOMER":-2}	null	
"CPLX0-7962_RXN"	{"CPLX0-7962":1,"G6759-MONOMER":-2}	"L-amino acid N-acyltransferase"	
"CPLX0-7963_RXN"	{"CPLX0-7963":1,"EMRE-MONOMER":-2}	"multidrug efflux pump EmrE / betaine:H<sup>+</sup> antiporter / choline:H<sup>+</sup> antiporter"	
"CPLX0-7964_RXN"	{"CPLX0-7964":1,"EG11009-MONOMER":-3}	"outer membrane channel TolC"	
"CPLX0-7970_RXN"	{"CPLX0-7970":1,"G7924-MONOMER":-2}	"HypT-[Met]reduced"	
"CPLX0-7973_RXN"	{"CPLX0-7973":1,"EG12313-MONOMER":-2}	"cell division factor ZapD"	
"CPLX0-7974_RXN"	{"CPLX0-7974":1,"EG11702-MONOMER":-2}	"RNA decapping hydrolase"	
"CPLX0-7975_RXN"	{"CPLX0-7975":1,"PD04413":-4}	"DNA-binding transcriptional repressor/NMN adenylyltransferase NadR"	
"CPLX0-7976_RXN"	{"CPLX0-7976":1,"G7875-MONOMER":null,"G7874-MONOMER":-1}	"translocation and assembly module"	
"CPLX0-7977_RXN"	{"CPLX0-7977":1,"EG11085-MONOMER":-2}	null	
"CPLX0-7979_RXN"	{"CPLX0-7979":1,"EG10144-MONOMER":-4}	"monoacetylchitobiose-6-phosphate hydrolase"	
"CPLX0-7981_RXN"	{"CPLX0-7981":1,"G6323-MONOMER":-7}	"miniconductance mechanosensitive channel YbdG"	
"CPLX0-7982_RXN"	{"CPLX0-7982":1,"MONOMER0-82":-7}	"small conductance mechanosensitive channel YnaI"	
"CPLX0-7983_RXN"	{"CPLX0-7983":1,"G6417-MONOMER":-7}	"moderate conductance mechanosensitive channel YbiO"	
"CPLX0-7984_RXN"	{"CPLX0-7984":1,"G7616-MONOMER":-2}	"glutathionyl-hydroquinone reductase YqjG"	
"CPLX0-7985_RXN"	{"CPLX0-7985":1,"G7840-MONOMER":-7}	"miniconductance mechanosensitive channel MscM"	
"CPLX0-7986_RXN"	{"CPLX0-7986":1,"EG10486-MONOMER":-1,"EG10485-MONOMER":-1}	"HypCD complex involved in hydrogenase maturation"	
"CPLX0-7987_RXN"	{"CPLX0-7987":1,"G7626-MONOMER":-3}	"predicted enamine/imine deaminase"	
"CPLX0-7988_RXN"	{"CPLX0-7988":1,"G6715-MONOMER":-6,"G6714-MONOMER":-6}	"PaaF-PaaG hydratase-isomerase complex"	
"CPLX0-7989_RXN"	{"CPLX0-7989":1,"G6662-MONOMER":-2}	"murein tripeptide amidase A"	
"CPLX0-7990_RXN"	{"CPLX0-7990":1,"RFFTRANS-MONOMER":-4}	"dTDP-4-dehydro-6-deoxy-D-glucose transaminase"	
"CPLX0-7992_RXN"	{"CPLX0-7992":1,"CPLX0-7628":-1,"G7889-MONOMER":-1,"G7664-MONOMER":-1,"YHBN-MONOMER":-1,"YHBG-MONOMER":-2,"G7888-MONOMER":-1}	"lipopolysaccharide transport system"	
"CPLX0-7993_RXN"	{"CPLX0-7993":1,"G6286-MONOMER":-2}	"ureidoglycolate dehydrogenase"	
"CPLX0-7994_RXN"	{"CPLX0-7994":1,"G6528-MONOMER":-1,"G6529-MONOMER":-1}	"poly-<i>N</i>-acetyl-D-glucosamine synthase"	
"CPLX0-7997_RXN"	{"CPLX0-7997":1,"DIAMINOPIMEPIM-MONOMER":-2}	"diaminopimelate epimerase"	
"CPLX0-7998_RXN"	{"CPLX0-7998":1,"EG12146-MONOMER":-4}	"RNase adaptor protein RapZ"	
"CPLX0-7_RXN"	{"CPLX0-7":1,"MONOMER0-5":-1,"CRR-MONOMER":-1}	"N-acetylmuramic acid-specific PTS enzyme II"	
"CPLX0-8005_RXN"	{"CPLX0-8005":1,"3-OXOACYL-ACP-REDUCT-MONOMER":-4}	"3-oxoacyl-[acyl-carrier-protein] reductase FabG"	
"CPLX0-8006_RXN"	{"CPLX0-8006":1,"ENOYL-ACP-REDUCT-NADH-MONOMER":-4}	"enoyl-[acyl-carrier-protein] reductase"	
"CPLX0-8008_RXN"	{"CPLX0-8008":1,"UDPGLCNACEPIM-MONOMER":-2}	null	
"CPLX0-8010_RXN"	{"CPLX0-8010":1,"G7020-MONOMER":-2}	null	
"CPLX0-8011_RXN"	{"CPLX0-8011":1,"GLCNACPTRANS-MONOMER":-2}	null	
"CPLX0-8012_RXN"	{"CPLX0-8012":1,"DTDPGLUCOSEPP2-MONOMER":-4}	null	
"CPLX0-8013_RXN"	{"CPLX0-8013":1,"UDPMANNACADEHYDROG-MONOMER":-2}	null	
"CPLX0-8014_RXN"	{"CPLX0-8014":1,"UDP-NACMUR-ALA-LIG-MONOMER":-2}	"UDP-<i>N</i>-acetylmuramate&mdash;L-alanine ligase"	
"CPLX0-8015_RXN"	{"CPLX0-8015":1,"ADHP-MONOMER":-4}	"ethanol dehydrogenase / alcohol dehydrogenase"	
"CPLX0-8016_RXN"	{"CPLX0-8016":1,"UDPHYDROXYMYRGLUCOSAMNACETYLTRANS-MONO":-3}	null	
"CPLX0-801_RXN"	{"CPLX0-801":1,"EG11398-MONOMER":-2}	"periplasmic acid stress chaperone HdeA"	
"CPLX0-8031_RXN"	{"CPLX0-8031":1,"PDXY-MONOMER":-2}	"pyridoxal kinase 2"	
"CPLX0-8032_RXN"	{"CPLX0-8032":1,"G7234-MONOMER":-2}	null	
"CPLX0-8033_RXN"	{"CPLX0-8033":1,"EG11101-MONOMER":-2}	null	
"CPLX0-8034_RXN"	{"CPLX0-8034":1,"DTDPGLUCOSEPP-MONOMER":-4}	null	
"CPLX0-8043_RXN"	{"CPLX0-8043":1,"G6799-MONOMER":-4}	"DNA-binding transcriptional repressor LsrR"	
"CPLX0-8044_RXN"	{"CPLX0-8044":1,"EG11828-MONOMER":-2}	"molybdopterin-guanine dinucleotide biosynthesis adaptor protein"	
"CPLX0-8045_RXN"	{"CPLX0-8045":1,"EG10153-MONOMER":-2}	"molybdopterin molybdotransferase"	
"CPLX0-8046_RXN"	{"CPLX0-8046":1,"SECB":-4}	"protein export chaperone SecB"	
"CPLX0-8089_RXN"	{"CPLX0-8089":1,"SECA":-2}	"protein translocation ATPase"	
"CPLX0-8090_RXN"	{"CPLX0-8090":1,"G6673-MONOMER":-4}	"diguanylate cyclase DgcM"	
"CPLX0-8092_RXN"	{"CPLX0-8092":1,"EG10564-MONOMER":-2}	"negative regulator of MalT activity/cystathionine &beta;-lyase"	
"CPLX0-8095_RXN"	{"CPLX0-8095":1,"G7365-MONOMER":-2}	"CP4-57 prophage; RNase LS, toxin of the RnlAB toxin-antitoxin system"	
"CPLX0-8096_RXN"	{"CPLX0-8096":1,"G7885-MONOMER":-2}	"ribonuclease E inhibitor protein B"	
"CPLX0-8097_RXN"	{"CPLX0-8097":1,"SBMA-MONOMER":-2}	null	
"CPLX0-8098_RXN"	{"CPLX0-8098":1,"UGD-MONOMER":-2}	null	
"CPLX0-8102_RXN"	{"CPLX0-8102":1,"TAR-MONOMER":-2}	"methyl-accepting chemotaxis protein Tar"	
"CPLX0-8103_RXN"	{"CPLX0-8103":1,"TSR-MONOMER":-2}	"methyl-accepting chemotaxis protein - serine-sensing"	
"CPLX0-8104_RXN"	{"CPLX0-8104":1,"TAP-MONOMER":-2}	"methyl-accepting chemotaxis protein - dipeptide-sensing"	
"CPLX0-8105_RXN"	{"CPLX0-8105":1,"TRG-MONOMER":-2}	"methyl-accepting chemotaxis protein Trg - ribose/galactose/glucose-sensing"	
"CPLX0-8106_RXN"	{"CPLX0-8106":1,"EG11298-MONOMER":-2}	"nucleoside triphosphate pyrophosphatase YhdE"	
"CPLX0-8107_RXN"	{"CPLX0-8107":1,"EG11535-MONOMER":-2}	"small heat shock protein IbpB"	
"CPLX0-8108_RXN"	{"CPLX0-8108":1,"EG11534-MONOMER":-2}	"small heat shock protein IbpA"	
"CPLX0-8109_RXN"	{"CPLX0-8109":1,"EG11236-MONOMER":-2}	"DNA-binding transcriptional activator/c-di-GMP phosphodiesterase PdeL"	
"CPLX0-8110_RXN"	{"CPLX0-8110":1,"G6154-MONOMER":-2}	"molybdenum cofactor insertion chaperone PaoD"	
"CPLX0-8111_RXN"	{"CPLX0-8111":1,"EG11064-MONOMER":-2}	"DNA helicase II"	
"CPLX0-8112_RXN"	{"CPLX0-8112":1,"EG11430-MONOMER":-2}	"ribosomal protein-arginine oxygenase"	
"CPLX0-8113_RXN"	{"CPLX0-8113":1,"EG10735-MONOMER":-2}	"phosphate signaling protein PhoU"	
"CPLX0-8119_RXN"	{"CPLX0-8119":1,"MONOMER0-6":-1,"G7250-MONOMER":-1,"G7246-MONOMER":-1}	"putative PTS enzyme II FryBCA"	
"CPLX0-8120_RXN"	{"CPLX0-8120":1,"ARTI-MONOMER":-1,"ARTM-MONOMER":-1,"ARTQ-MONOMER":-1,"ARTP-MONOMER":-2}	"putative ABC transporter ArtPQMI"	
"CPLX0-8121_RXN"	{"CPLX0-8121":1,"EG11315-MONOMER":-2}	"acrylyl-CoA reductase"	
"CPLX0-8122_RXN"	{"CPLX0-8122":1,"EG12310-MONOMER":-6}	"aminopeptidase B"	
"CPLX0-8123_RXN"	{"CPLX0-8123":1,"G7431-MONOMER":-6}	"6-carboxy-5,6,7,8-tetrahydropterin synthase"	
"CPLX0-8124_RXN"	{"CPLX0-8124":1,"G6675-MONOMER":-2}	"tRNA cytosine<sup>32</sup> 2-sulfurtransferase TtcA"	
"CPLX0-8125_RXN"	{"CPLX0-8125":1,"EG12259-MONOMER":null,"EG12260-MONOMER":null}	"cellulose synthase"	
"CPLX0-8127_RXN"	{"CPLX0-8127":1,"G6721-MONOMER":-3}	null	
"CPLX0-8128_RXN"	{"CPLX0-8128":1,"G6912-MONOMER":-4}	null	
"CPLX0-8129_RXN"	{"CPLX0-8129":1,"G6303-MONOMER":-2}	"DLP12 prophage; DNA base-flipping protein"	
"CPLX0-8152_RXN"	{"CPLX0-8152":1,"EG12347-MONOMER":-2,"G7037-MONOMER":-2,"G7039-MONOMER":-1}	"cystine ABC transporter"	
"CPLX0-8154_RXN"	{"CPLX0-8154":1,"G7880-MONOMER":-2}	"c-di-GMP-binding biofilm dispersal mediator protein"	
"CPLX0-8155_RXN"	{"CPLX0-8155":1,"G7816-MONOMER":-2}	"periplasmic protein CpxP"	
"CPLX0-8156_RXN"	{"CPLX0-8156":1,"EG10698-MONOMER":-2}	null	
"CPLX0-8157_RXN"	{"CPLX0-8157":1,"EG10680-MONOMER":-2}	"osmotically inducible peroxiredoxin OsmC"	
"CPLX0-8158_RXN"	{"CPLX0-8158":1,"DLACTDEHYDROGNAD-MONOMER":-4}	"D-lactate dehydrogenase"	
"CPLX0-8159_RXN"	{"CPLX0-8159":1,"G7596-MONOMER":-2}	"putrescine aminotransferase"	
"CPLX0-8160_RXN"	{"CPLX0-8160":1,"SUCC-DEHASE":-3}	null	
"CPLX0-8163_RXN"	{"CPLX0-8163":1,"EG11511-MONOMER":-3}	null	
"CPLX0-8164_RXN"	{"CPLX0-8164":1,"EG10154-MONOMER":-2}	null	
"CPLX0-8165_RXN"	{"CPLX0-8165":1,"EG10976-MONOMER":-4}	"ssDNA-binding protein"	
"CPLX0-8167_RXN"	{"CPLX0-8167":1,"FORMHYDROGI-CPLX":-2}	"hydrogenase 1, oxygen tolerant hydrogenase"	
"CPLX0-8168_RXN"	{"CPLX0-8168":1,"PHOQ-MONOMER":-2}	"bifunctional sensor histidine kinase PhoQ"	
"CPLX0-8173_RXN"	{"CPLX0-8173":1,"EG12845-MONOMER":-2}	"CRISPR-associated endoribonuclease Cas2"	
"CPLX0-8174_RXN"	{"CPLX0-8174":1,"CPLX0-8173":-1,"CPLX0-7914":-1}	"Cas1-Cas2 complex"	
"CPLX0-8175_RXN"	{"CPLX0-8175":1,"EG11859-MONOMER":-2}	"sulfurtransferase for molybdenum cofactor sulfuration"	
"CPLX0-8176_RXN"	{"CPLX0-8176":1,"G7456-MONOMER":-2}	null	
"CPLX0-8177_RXN"	{"CPLX0-8177":1,"MONOMER0-1701":-2}	"putative phosphatidylethanolamine synthesis regulator GnsA"	
"CPLX0-8180_RXN"	{"CPLX0-8180":1,"EG10157-MONOMER":-6}	"disaggregating chaperone protein ClpB"	
"CPLX0-8181_RXN"	{"CPLX0-8181":1,"G6991-MONOMER":-1,"EG11171-MONOMER":-1}	"N<sup>6</sup>-L-threonylcarbamoyladenine synthase, TsaB-TsaD dimer subunit"	
"CPLX0-8182_RXN"	{"CPLX0-8182":1,"EG11757-MONOMER":-1,"CPLX0-8181":null}	"N<sup>6</sup>-L-threonylcarbamoyladenine synthase"	
"CPLX0-8183_RXN"	{"CPLX0-8183":1,"EG11652-MONOMER":-3}	null	
"CPLX0-8184_RXN"	{"CPLX0-8184":1,"EG11580-MONOMER":-2}	"nonspecific DNA-binding protein YbiB"	
"CPLX0-8185_RXN"	{"CPLX0-8185":1,"EG12391-MONOMER":-2}	"PF10636 family protein YdiE"	
"CPLX0-8186_RXN"	{"CPLX0-8186":1,"GALACTITOLPDEHYD-MONOMER":-2}	null	
"CPLX0-8187_RXN"	{"CPLX0-8187":1,"G7682-MONOMER":-12}	"periplasmic serine endoprotease"	
"CPLX0-8188_RXN"	{"CPLX0-8188":1,"EG10597-MONOMER":-2,"EG10596-MONOMER":-2}	"Z-ring inhibitor complex MinCD"	
"CPLX0-8189_RXN"	{"CPLX0-8189":1,"G7350-MONOMER":-4}	null	
"CPLX0-8190_RXN"	{"CPLX0-8190":1,"G7021-MONOMER":-4}	null	
"CPLX0-8191_RXN"	{"CPLX0-8191":1,"EG10240-MONOMER":-2}	"chaperone protein DnaJ"	
"CPLX0-8192_RXN"	{"CPLX0-8192":1,"EG10416-MONOMER":-2}	"nucleotide exchange factor GrpE"	
"CPLX0-8196_RXN"	{"CPLX0-8196":1,"EG10596-MONOMER":-2}	"Z-ring positioning protein MinC"	
"CPLX0-8198_RXN"	{"CPLX0-8198":1,"EG12371-MONOMER":-2}	"lipoprotein NlpI"	
"CPLX0-8199_RXN"	{"CPLX0-8199":1,"G6783-MONOMER":-2}	"oxygen-sensing c-di-GMP phosphodiesterase DosP"	
"CPLX0-8200_RXN"	{"CPLX0-8200":1,"G7314-MONOMER":-2}	"cyclic di-GMP phosphodiesterase PdeF"	
"CPLX0-8201_RXN"	{"CPLX0-8201":1,"G7394-MONOMER":-4}	"glutarate dioxygenase GlaH"	
"CPLX0-8202_RXN"	{"CPLX0-8202":1,"ALARACEBIOSYN-MONOMER":-2}	"alanine racemase 1"	
"CPLX0-8204_RXN"	{"CPLX0-8204":1,"EG11918-MONOMER":-8}	"signaling pathway modulator ZraP"	
"CPLX0-8205_RXN"	{"CPLX0-8205":1,"GLUC1PURIDYLTRANS-MONOMER":-4}	null	
"CPLX0-8206_RXN"	{"CPLX0-8206":1,"EG12399-MONOMER":-2}	"dihydroxyacetone kinase, phosphotransferase component"	
"CPLX0-8207_RXN"	{"CPLX0-8207":1,"EG11399-MONOMER":-2}	"periplasmic acid stress chaperone HdeB"	
"CPLX0-8208_RXN"	{"CPLX0-8208":1,"EG10917-MONOMER":null,"EG10905-MONOMER":null}	"S6:S18 ribosomal subunit complex"	
"CPLX0-8211_RXN"	{"CPLX0-8211":1,"THZ-KIN-MONOMER":-2}	null	
"CPLX0-8212_RXN"	{"CPLX0-8212":1,"ERYTHRON4PDEHYDROG-MONOMER":-2}	null	
"CPLX0-8213_RXN"	{"CPLX0-8213":1,"G7060-MONOMER":-1,"G7059-MONOMER":-1}	"periplasmic protein-L-methionine sulfoxide reducing system"	
"CPLX0-8214_RXN"	{"CPLX0-8214":1,"G7853-MONOMER":-2}	"carboxylesterase"	
"CPLX0-8217_RXN"	{"CPLX0-8217":1,"G7005-MONOMER":-2}	"free methionine-(<i>R</i>)-sulfoxide reductase"	
"CPLX0-8218_RXN"	{"CPLX0-8218":1,"G6784-MONOMER":-2}	"diguanylate cyclase DosC"	
"CPLX0-8219_RXN"	{"CPLX0-8219":1,"G7398-MONOMER":-2}	"thiosulfate sulfurtransferase YgaP"	
"CPLX0-821_RXN"	{"CPLX0-821":1,"G7723-MONOMER":-12}	"fructoselysine 6-phosphate deglycase"	
"CPLX0-8223_RXN"	{"CPLX0-8223":1,"EG12179-MONOMER":-2}	"transcription antiterminator and regulator of RNA stability"	
"CPLX0-8227_RXN"	{"CPLX0-8227":1,"EG10307-MONOMER":-1,"EG12374-MONOMER":-1}	"FicT-FicA complex"	
"CPLX0-8229_RXN"	{"CPLX0-8229":1,"G7601-MONOMER":-2}	"antitoxin/DNA-binding transcriptional repressor HigA"	
"CPLX0-8230_RXN"	{"CPLX0-8230":1,"CPLX0-8229":-1,"G7602-MONOMER":-2}	"HigB-HigA toxin/antitoxin complex and DNA-binding transcriptional repressor"	
"CPLX0-8231_RXN"	{"CPLX0-8231":1,"G7641-MONOMER":-2}	null	
"CPLX0-8232_RXN"	{"CPLX0-8232":1,"G6989-MONOMER":null,"G6988-MONOMER":null}	"carnitine monooxygenase"	
"CPLX0-8233_RXN"	{"CPLX0-8233":1,"EG12033-MONOMER":-3}	null	
"CPLX0-8234_RXN"	{"CPLX0-8234":1,"G6209-MONOMER":-4}	"DNA-binding transcriptional repressor FrmR"	
"CPLX0-8237_RXN"	{"CPLX0-8237":1,"G6306-MONOMER":-2}	"DLP12 prophage; crossover junction endodeoxyribonuclease RusA"	
"CPLX0-8238_RXN"	{"CPLX0-8238":1,"NRFD-MONOMER":-1,"NRFC-MONOMER":-1}	"putative menaquinol-cytochrome <i>c</i> reductase NrfCD"	
"CPLX0-8239_RXN"	{"CPLX0-8239":1,"G7657-MONOMER":-1,"EG12181-MONOMER":-1}	"Grx4-IbaG complex"	
"CPLX0-8240_RXN"	{"CPLX0-8240":1,"EG11404-MONOMER":-2}	"redox-responsive ATPase YchF"	
"CPLX0-8244_RXN"	{"CPLX0-8244":1,"G6491-MONOMER":-6}	"intermembrane transport protein PqiB"	
"CPLX0-8245_RXN"	{"CPLX0-8245":1,"EG10018-MONOMER":-4}	"regulator of CsrB and CsrC decay"	
"CPLX0-8247_RXN"	{"CPLX0-8247":1,"URAA-MONOMER":-2}	null	
"CPLX0-8248_RXN"	{"CPLX0-8248":1,"G7192-MONOMER":-4}	"phosphodiesterase YfcE"	
"CPLX0-8249_RXN"	{"CPLX0-8249":1,"G6381-MONOMER":null,"G6380-MONOMER":null,"G6382-MONOMER":null}	"5-oxoprolinase"	
"CPLX0-8251_RXN"	{"CPLX0-8251":1,"EG11157-MONOMER":-2}	"amino acid racemase YgeA"	
"CPLX0-8252_RXN"	{"CPLX0-8252":1,"EG10201-MONOMER":-2}	"D-alanyl-D-alanine carboxypeptidase DacA"	
"CPLX0-8254_RXN"	{"CPLX0-8254":1,"EG10203-MONOMER":-2}	"D-alanyl-D-alanine carboxypeptidase DacC"	
"CPLX0-8255_RXN"	{"CPLX0-8255":1,"PTSG-MONOMER":null,"PD01896":null}	"Mlc-PtsG"	
"CPLX0-8256_RXN"	{"CPLX0-8256":1,"EG10466-MONOMER":-2}	"HU&alpha;&alpha;"	
"CPLX0-8259_RXN"	{"CPLX0-8259":1,"EG11870-MONOMER":-2}	"2-amino-6-<i>N</i>-hydroxylaminopurine resistance protein"	
"CPLX0-8260_RXN"	{"CPLX0-8260":1,"DTMPKI-MONOMER":-2}	"dTMP kinase"	
"CPLX0-8261_RXN"	{"CPLX0-8261":1,"TDK-MONOMER":null}	null	
"CPLX0-8262_RXN"	{"CPLX0-8262":1,"EG12373-MONOMER":-4}	"nucleotide 5'-monophosphate nucleosidase"	
"CPLX0-8263_RXN"	{"CPLX0-8263":1,"SUGE-MONOMER":-2}	"guanidinium exporter"	
"CPLX0-8269_RXN"	{"CPLX0-8269":1,"G7597-MONOMER":-2}	"putative tRNA-binding protein YgjH"	
"CPLX0-8270_RXN"	{"CPLX0-8270":1,"CPXA-MONOMER":-2}	"sensor histidine kinase CpxA"	
"CPLX0-8271_RXN"	{"CPLX0-8271":1,"EG12209-MONOMER":-2}	null	
"CPLX0-8275_RXN"	{"CPLX0-8275":1,"G7345-MONOMER":-2}	"histidine kinase GlrK"	
"CPLX0-8280_RXN"	{"CPLX0-8280":1,"G6358-MONOMER":-4}	"pyrimidine-specific ribonucleoside hydrolase RihA"	
"CPLX0-8281_RXN"	{"CPLX0-8281":1,"G6865-MONOMER":-2}	"DUF945 domain-containing protein YdgA"	
"CPLX0-8285_RXN"	{"CPLX0-8285":1,"OMPR-MONOMER":-2}	"OmpR dimer"	
"CPLX0-8288_RXN"	{"CPLX0-8288":1,"G6318-MONOMER":-2}	"sensor histidine kinase CusS"	
"CPLX0-8290_RXN"	{"CPLX0-8290":1,"G7248-MONOMER":-2}	"aminopeptidase YpdF"	
"CPLX0-8291_RXN"	{"CPLX0-8291":1,"G7531-MONOMER":-2}	"heme chaperone HemW"	
"CPLX0-8292_RXN"	{"CPLX0-8292":1,"GLUCONREDUCT-MONOMER":-2}	null	
"CPLX0-8299_RXN"	{"CPLX0-8299":1,"PRPPSYN-MONOMER":-6}	null	
"CPLX0-8300_RXN"	{"CPLX0-8300":1,"MONOMER0-4521":-2}	"PBP1B&gamma;"	
"CPLX0-8301_RXN"	{"CPLX0-8301":1,"G7582-MONOMER":null,"EG11474-MONOMER":null,"EG11333-MONOMER":null,"OCTAPRENYL-METHOXYPHENOL-OH-MONOMER":null,"DHHB-METHYLTRANSFER-MONOMER":null,"OCTAPRENYL-METHYL-METHOXY-BENZOQ-OH-MON":null,"2-OCTAPRENYL-METHOXY-BENZOQ-METH-MONOMER":null}	"Ubi complex"	
"CPLX0-8302_RXN"	{"CPLX0-8302":1,"BARA-MONOMER":-2}	"sensor histidine kinase BarA"	
"CPLX0-8303_RXN"	{"CPLX0-8303":1,"G6520-MONOMER":-2}	"putative aminoacrylate hydrolase RutD"	
"CPLX0-8304_RXN"	{"CPLX0-8304":1,"DCUB-MONOMER":-1,"DCUS-MONOMER":-1}	"DcuS-DcuB sensor complex"	
"CPLX0-8306_RXN"	{"CPLX0-8306":1,"DCTA-MONOMER":-1,"DCUS-MONOMER":-1}	"DcuS-DctA sensor complex"	
"CPLX0-8308_RXN"	{"CPLX0-8308":1,"G7653-MONOMER":-1,"G7652-MONOMER":-1}	"ubiquinone biosynthesis complex UbiUV"	
"CPLX0-8311_RXN"	{"CPLX0-8311":1,"MONOMER0-1041":-2}	null	
"CPLX0-8312_RXN"	{"CPLX0-8312":1,"G6494-MONOMER":null,"PD00257":null}	"DNA-binding transcriptional  repressor CRP-Sxy"	
"CPLX0-8314_RXN"	{"CPLX0-8314":1,"EVGS-MONOMER":-2}	"sensor histidine kinase EvgS"	
"CPLX0-8315_RXN"	{"CPLX0-8315":1,"EG10574-MONOMER":-6}	"McrB hexamer"	
"CPLX0-841_RXN"	{"CPLX0-841":1,"EG10571-MONOMER":-2}	"MazE antitoxin of the MazF-MazE toxin-antitoxin system / DNA-binding transcriptional repressor"	
"CPLX0-8535_RXN"	{"CPLX0-8535":1,"EG12396-MONOMER":-2}	"putative diguanylate cyclase DgcE"	
"CPLX0-8536_RXN"	{"CPLX0-8536":1,"EG11210-MONOMER":null}	"regulator of diguanylate cyclase RdcA"	
"CPLX0-8537_RXN"	{"CPLX0-8537":1,"GALACTARDEHYDRA-MONOMER":-2}	"galactarate dehydratase"	
"CPLX0-8538_RXN"	{"CPLX0-8538":1,"G6708-MONOMER":-6}	null	
"CPLX0-8539_RXN"	{"CPLX0-8539":1,"G7689-MONOMER":-1,"EG10741-MONOMER":-1}	"metalloprotease TldDE"	
"CPLX0-8541_RXN"	{"CPLX0-8541":1,"G6414-MONOMER":null,"CPLX0-1923":null}	"iron-catecholate outer membrane transport complex I"	
"CPLX0-8542_RXN"	{"CPLX0-8542":1,"G6174-MONOMER":-2}	"cupric reductase RclA"	
"CPLX0-8544_RXN"	{"CPLX0-8544":1,"G7901-MONOMER":-2}	"KpLE2 phage-like element; 2,7-anhydro-<i>N</i>-acetylneuraminate hydratase"	
"CPLX0-8545_RXN"	{"CPLX0-8545":1,"EG10202-MONOMER":-2}	"peptidoglycan DD endopeptidase DacB"	
"CPLX0-8547_RXN"	{"CPLX0-8547":1,"G6960-MONOMER":-4}	null	
"CPLX0-8548_RXN"	{"CPLX0-8548":1,"G6959-MONOMER":-2}	null	
"CPLX0-8549_RXN"	{"CPLX0-8549":1,"EG11436-MONOMER":-2}	"NADPH-dependent aldehyde reductase Ahr"	
"CPLX0-8550_RXN"	{"CPLX0-8550":1,"G6577-MONOMER":-2}	"protein-lysine deacetylase/desuccinylase/lipoamidase"	
"CPLX0-8551_RXN"	{"CPLX0-8551":1,"G7007-MONOMER":-6}	"lipophilic envelope spanning tunnel"	
"CPLX0-8553_RXN"	{"CPLX0-8553":1,"CPLX0-1923":null,"EG10155-MONOMER":-1}	"iron-catecholate outer membrane transport complex II"	
"CPLX0-8554_RXN"	{"CPLX0-8554":1,"G6652-MONOMER":-4}	null	
"CPLX0-8555_RXN"	{"CPLX0-8555":1,"EG12256-MONOMER":-2}	"c-di-GMP phosphodiesterase PdeK"	
"CPLX0-8556_RXN"	{"CPLX0-8556":1,"EG11257-MONOMER":-2}	"diguanylate cyclase DgcC"	
"CPLX0-8557_RXN"	{"CPLX0-8557":1,"EG10215-MONOMER":-2}	"ATP-dependent RNA helicase DeaD"	
"CPLX0-8558_RXN"	{"CPLX0-8558":1,"THIF-MONOMER":-2}	"sulfur carrier protein ThiS adenylyltransferase"	
"CPLX0-8560_RXN"	{"CPLX0-8560":1,"EG12690-MONOMER":-4}	"replication-associated recombination protein A"	
"CPLX0-8561_RXN"	{"CPLX0-8561":1,"G6329-MONOMER":-2}	"methionine transaminase"	
"CPLX0-8562_RXN"	{"CPLX0-8562":1,"G7696-MONOMER":-3}	"hexapeptide repeats-containing protein YrdA"	
"CPLX0-8563_RXN"	{"CPLX0-8563":1,"G6882-MONOMER":-2}	"DNA-binding transcriptional dual regulator SlyA"	
"CPLX0-8565_RXN"	{"CPLX0-8565":1,"EG11825-MONOMER":-2}	"PF02567 family protein YddE"	
"CPLX0-861_RXN"	{"CPLX0-861":1,"G7055-MONOMER":-2}	"protein/nucleic acid deglycase 1"	
"CPLX0-881_RXN"	{"CPLX0-881":1,"EG10156-MONOMER":-6}	"ClpA ATP-dependent protease specificity component and chaperone"	
"CPLX0-901_RXN"	{"CPLX0-901":1,"EG11372-MONOMER":-2}	"tRNA adenosine<sup>34</sup> deaminase"	
"CPLX0-902_RXN"	{"CPLX0-902":1,"EG11761-MONOMER":-2}	"tautomerase PptA"	
"CPLX0-921_RXN"	{"CPLX0-921":1,"G6104-MONOMER":-2}	"periplasmic chaperone, inhibitor of vertebrate C-type lysozyme"	
"CPLX0-981_RXN"	{"CPLX0-981":1,"EG12344-MONOMER":-6}	"DNA-binding transcriptional dual regulator PspF"	
"CPLXECOLI-7943_RXN"	{"CPLXECOLI-7943":1,"G7409-MONOMER":-2}	null	
"CREC-CPLX_RXN"	{"CREC-CPLX":1,"CREC-MONOMER":-2}	"sensor histidine kinase CreC"	
"CTPSYN-CPLX_RXN"	{"CTPSYN-CPLX":1,"CTPSYN-MONOMER":-4}	"CTP synthetase"	
"CYANLY-CPLX_RXN"	{"CYANLY-CPLX":1,"CYANLY-MONOMER":-10}	"cyanase"	
"CYSSYNMULTI-CPLX_RXN"	{"CYSSYNMULTI-CPLX":1,"CPLX0-237":-1,"ACSERLYA-CPLX":-1}	"cysteine synthase complex"	
"CYSTATHIONINE-BETA-LYASE-CPLX_RXN"	{"CYSTATHIONINE-BETA-LYASE-CPLX":1,"CYSTATHIONINE-BETA-LYASE-MONOMER":-4}	null	
"CYT-D-UBIOX-CPLX_RXN"	{"CYT-D-UBIOX-CPLX":1,"CYDA-MONOMER":-1,"CYDB-MONOMER":-1,"MONOMER0-2663":-1,"MONOMER0-2822":-1}	"cytochrome <i>bd</i>-I ubiquinol oxidase"	
"CYT-O-UBIOX-CPLX_RXN"	{"CYT-O-UBIOX-CPLX":1,"CYOD-MONOMER":-1,"CYOA-MONOMER":-1,"CYOB-MONOMER":-1,"CYOC-MONOMER":-1}	"cytochrome <i>bo<sub>3</sub></i> ubiquinol oxidase"	
"CYTIDEAM-CPLX_RXN"	{"CYTIDEAM-CPLX":1,"CYTIDEAM-MONOMER":-2}	"cytidine/deoxycytidine deaminase"	
"DALADALALIGB-CPLX_RXN"	{"DALADALALIGB-CPLX":1,"DALADALALIGB-MONOMER":-2}	"D-alanine&mdash;D-alanine ligase B"	
"DALADEHYDROG-CPLX_RXN"	{"DALADEHYDROG-CPLX":1,"DALADEHYDROGA-MONOMER":-2}	"D-amino acid dehydrogenase"	
"DAPASYN-CPLX_RXN"	{"DAPASYN-CPLX":1,"DAPASYN-MONOMER":-2}	"adenosylmethionine-8-amino-7-oxononanoate aminotransferase"	
"DCTP-DEAM-CPLX_RXN"	{"DCTP-DEAM-CPLX":1,"DCTP-DEAM-MONOMER":-3}	null	
"DCYSDESULF-CPLX_RXN"	{"DCYSDESULF-CPLX":1,"DCYSDESULF-MONOMER":-2}	null	
"DEOA-CPLX_RXN"	{"DEOA-CPLX":1,"DEOA-MONOMER":-2}	null	
"DEOD-CPLX_RXN"	{"DEOD-CPLX":1,"DEOD-MONOMER":-6}	"purine nucleoside phosphorylase"	
"DETHIOBIOTIN-SYN-CPLX_RXN"	{"DETHIOBIOTIN-SYN-CPLX":1,"DETHIOBIOTIN-SYN-MONOMER":-2}	null	
"DGTPTRIPHYDRO-CPLX_RXN"	{"DGTPTRIPHYDRO-CPLX":1,"DGTPTRIPHYDRO-MONOMER":-6}	null	
"DHPDIOXYGEN-CPLX_RXN"	{"DHPDIOXYGEN-CPLX":1,"DHPDIOXYGEN-MONOMER":-4}	"3-carboxyethylcatechol 2,3-dioxygenase"	
"DIACYLGLYKIN-CPLX_RXN"	{"DIACYLGLYKIN-CPLX":1,"DIACYLGLYKIN-MONOMER":-3}	null	
"DIAMINOPIMDECARB-CPLX_RXN"	{"DIAMINOPIMDECARB-CPLX":1,"DIAMINOPIMDECARB-MONOMER":-2}	null	
"DIHYDRODIPICSYN-CPLX_RXN"	{"DIHYDRODIPICSYN-CPLX":1,"DIHYDRODIPICSYN-MONOMER":-4}	"4-hydroxy-tetrahydrodipicolinate synthase"	
"DIHYDROOROT-CPLX_RXN"	{"DIHYDROOROT-CPLX":1,"DIHYDROOROT-MONOMER":-2}	null	
"DIHYDROPICRED-CPLX_RXN"	{"DIHYDROPICRED-CPLX":1,"DIHYDROPICRED-MONOMER":-4}	"4-hydroxy-tetrahydrodipicolinate reductase"	
"DIHYDROPTERIREDUCT-CPLX_RXN"	{"DIHYDROPTERIREDUCT-CPLX":1,"DIHYDROPTERIREDUCT-MONOMER":-2}	"NAD(P)H nitroreductase NfsB"	
"DIHYDROXYACIDDEHYDRAT-CPLX_RXN"	{"DIHYDROXYACIDDEHYDRAT-CPLX":1,"DIHYDROXYACIDDEHYDRAT-MONOMER":-2}	"dihydroxy-acid dehydratase"	
"DIMESULFREDUCT-CPLX_RXN"	{"DIMESULFREDUCT-CPLX":1,"DMSA-MONOMER":-1,"DMSB-MONOMER":-1,"DMSC-MONOMER":-1}	null	
"DIOHBUTANONEPSYN-CPLX_RXN"	{"DIOHBUTANONEPSYN-CPLX":1,"DIOHBUTANONEPSYN-MONOMER":-2}	null	
"DMBPPRIBOSYLTRANS-CPLX_RXN"	{"DMBPPRIBOSYLTRANS-CPLX":1,"DMBPPRIBOSYLTRANS-MONOMER":-2}	null	
"DSBC-CPLX_RXN"	{"DSBC-CPLX":1,"DSBC-MONOMER":-2}	"protein disulfide isomerase DsbC"	
"DSBG-CPLX_RXN"	{"DSBG-CPLX":1,"DSBG-MONOMER":-2}	"protein sulfenic acid reductase and chaperone DsbG"	
"DTDPGLUCDEHYDRAT-CPLX_RXN"	{"DTDPGLUCDEHYDRAT-CPLX":1,"DTDPGLUCDEHYDRAT-MONOMER":-2}	"dTDP-glucose 4,6-dehydratase 1"	
"DUTP-PYROP-CPLX_RXN"	{"DUTP-PYROP-CPLX":1,"DUTP-PYROP-MONOMER":-3}	"dUTP diphosphatase"	
"DXPREDISOM-CPLX_RXN"	{"DXPREDISOM-CPLX":1,"DXPREDISOM-MONOMER":-2}	null	
"E1O_RXN"	{"E1O":1,"E1O-MONOMER":-12}	"2-oxoglutarate decarboxylase, thiamine-requiring"	
"E1P-CPLX_RXN"	{"E1P-CPLX":1,"E1P-MONOMER":-2}	"pyruvate dehydrogenase"	
"E2O_RXN"	{"E2O":1,"E2O-MONOMER":-24}	null	
"E3-CPLX_RXN"	{"E3-CPLX":1,"E3-MONOMER":-2}	"lipoamide dehydrogenase"	
"EIISGA_RXN"	{"EIISGA":1,"YJFU-MONOMER":-1,"YJFT-MONOMER":-1,"SGAT-MONOMER":-2}	"L-ascorbate specific PTS enzyme II"	
"EIISGC_RXN"	{"EIISGC":1,"MONOMER0-2121":null,"SGCC-MONOMER":null,"SGCA-MONOMER":null}	"putative PTS enzyme II SgcBCA"	
"ENOLASE-CPLX_RXN"	{"ENOLASE-CPLX":1,"ENOLASE-MONOMER":-2}	null	
"ENTA-CPLX_RXN"	{"ENTA-CPLX":1,"ENTA-MONOMER":-4}	null	
"ENTE-CPLX_RXN"	{"ENTE-CPLX":1,"ENTE-MONOMER":-2}	"2,3-dihydroxybenzoate-[aryl-carrier protein] ligase"	
"ENTMULTI-CPLX_RXN"	{"ENTMULTI-CPLX":1,"ENTB-CPLX":-1,"ENTD-MONOMER":-1,"ENTF-PANT":-1,"ENTE-CPLX":-1}	null	
"ENVZ-CPLX_RXN"	{"ENVZ-CPLX":1,"ENVZ-MONOMER":-2}	"sensor histidine kinase EnvZ"	
"ERYTH4PDEHYDROG-CPLX_RXN"	{"ERYTH4PDEHYDROG-CPLX":1,"ERYTH4PDEHYDROG-MONOMER":-4}	null	
"ETHAMLY-CPLX_RXN"	{"ETHAMLY-CPLX":1,"EUTB-MONOMER":-6,"EUTC-MONOMER":-6}	null	
"F-1-CPLX_RXN"	{"F-1-CPLX":1,"ATPC-MONOMER":-1,"ATPH-MONOMER":-1,"ATPA-CPLX":-1,"ATPG-MONOMER":-1,"ATPD-CPLX":-1}	"ATP synthase F<sub>1</sub> complex"	
"F-O-CPLX_RXN"	{"F-O-CPLX":1,"ATPE-CPLX":-1,"ATPF-CPLX":-1,"ATPB-MONOMER":-1}	"ATP synthase F<sub>o</sub> complex"	
"F16B-CPLX_RXN"	{"F16B-CPLX":1,"F16B-MONOMER":-4}	"fructose-1,6-bisphosphatase 1"	
"FABA-CPLX_RXN"	{"FABA-CPLX":1,"FABA-MONOMER":-2}	"&beta;-hydroxyacyl-acyl carrier protein dehydratase/isomerase"	
"FABB-CPLX_RXN"	{"FABB-CPLX":1,"FABB-MONOMER":-2}	"3-oxoacyl-[acyl carrier protein] synthase 1"	
"FABZ-CPLX_RXN"	{"FABZ-CPLX":1,"FABZ-MONOMER":-6}	"3-hydroxy-acyl-[acyl-carrier-protein] dehydratase"	
"FAO-CPLX_RXN"	{"FAO-CPLX":1,"FADB-MONOMER":-2,"FADA-MONOMER":-2}	"aerobic fatty acid oxidation complex"	
"FHLMULTI-CPLX_RXN"	{"FHLMULTI-CPLX":1,"FORMATEDEHYDROGH-MONOMER":-1,"HYDROG3-CPLX":-1}	null	
"FLAGELLAR-MOTOR-COMPLEX_RXN"	{"FLAGELLAR-MOTOR-COMPLEX":1,"CPLX0-7450":null,"FLGH-FLAGELLAR-L-RING":null,"MOTA-FLAGELLAR-MOTOR-STATOR-PROTEIN":null,"MOTB-FLAGELLAR-MOTOR-STATOR-PROTEIN":null,"FLGB-FLAGELLAR-MOTOR-ROD-PROTEIN":null,"FLGC-FLAGELLAR-MOTOR-ROD-PROTEIN":null,"FLGF-FLAGELLAR-MOTOR-ROD-PROTEIN":null,"FLGG-FLAGELLAR-MOTOR-ROD-PROTEIN":null,"FLGI-FLAGELLAR-P-RING":null,"FLIF-FLAGELLAR-MS-RING":null}	"flagellar basal body"	
"FOLD-CPLX_RXN"	{"FOLD-CPLX":1,"FOLD-MONOMER":-2}	"bifunctional methylenetetrahydrofolate dehydrogenase / methenyltetrahydrofolate cyclohydrolase"	
"FOLE-CPLX_RXN"	{"FOLE-CPLX":1,"GTP-CYCLOHYDRO-I-MONOMER":-10}	"GTP cyclohydrolase 1"	
"FOLXTET-CPLX_RXN"	{"FOLXTET-CPLX":1,"H2NTPEPIM-MONOMER":-8}	"dihydroneopterin triphosphate 2'-epimerase"	
"FORMATEDEHYDROGN-CPLX_RXN"	{"FORMATEDEHYDROGN-CPLX":1,"ALPHA-SUBUNIT-CPLX":-3}	null	
"FORMATEDEHYDROGO-CPLX_RXN"	{"FORMATEDEHYDROGO-CPLX":1,"FDOG-MONOMER":-1,"FDOH-MONOMER":-1,"FDOI-MONOMER":-1}	"formate dehydrogenase O"	
"FORMHYDROG2-CPLX_RXN"	{"FORMHYDROG2-CPLX":1,"HYBA-MONOMER":-1,"EG11800-MONOMER":-1,"MONOMER0-145":-1,"HYBC-MONOMER":-1}	"hydrogenase 2"	
"FORMHYDROGI-CPLX_RXN"	{"FORMHYDROGI-CPLX":1,"HYAA-MONOMER":-2,"HYAB-MONOMER":-2,"HYAC-MONOMER":-1}	"hydrogenase 1"	
"FORMYLTHFDEFORMYL-CPLX_RXN"	{"FORMYLTHFDEFORMYL-CPLX":1,"FORMYLTHFDEFORMYL-MONOMER":-6}	null	
"FRUCBISALD-CLASSII_RXN"	{"FRUCBISALD-CLASSII":1,"FRUCTBISALD-CLASSII-MONOMER":-2}	"fructose-bisphosphate aldolase class II"	
"FRUCBISALD-CLASSI_RXN"	{"FRUCBISALD-CLASSI":1,"FRUCBISALD-CLASSI-MONOMER":-10}	"fructose-bisphosphate aldolase class I"	
"FUMARASE-A_RXN"	{"FUMARASE-A":1,"FUMA-MONOMER":-2}	"fumarase A"	
"FUMARASE-B_RXN"	{"FUMARASE-B":1,"FUMB-MONOMER":-2}	"fumarase B"	
"FUMARASE-C_RXN"	{"FUMARASE-C":1,"FUMC-MONOMER":-4}	"fumarase C"	
"FUMARATE-REDUCTASE_RXN"	{"FUMARATE-REDUCTASE":1,"FUM-FLAVO":-1,"FUM-FE-S":-1,"FUM-MEMB1":-1,"FUM-MEMB2":-1}	null	
"GABATRANSAM-CPLX_RXN"	{"GABATRANSAM-CPLX":1,"GABATRANSAM-MONOMER":-2}	"4-aminobutyrate aminotransferase GabT"	
"GALACTOACETYLTRAN-CPLX_RXN"	{"GALACTOACETYLTRAN-CPLX":1,"GALACTOACETYLTRAN-MONOMER":-3}	null	
"GALACTURIDYLYLTRANS-CPLX_RXN"	{"GALACTURIDYLYLTRANS-CPLX":1,"GALACTURIDYLYLTRANS-MONOMER":-2}	"galactose-1-phosphate uridylyltransferase"	
"GAPDH-A-CPLX_RXN"	{"GAPDH-A-CPLX":1,"GAPDH-A-MONOMER":-4}	null	
"GCVMULTI-CPLX_RXN"	{"GCVMULTI-CPLX":1,"E3-CPLX":-1,"GCVP-CPLX":-1,"LIPOYL-GCVH":-1,"GCVT-MONOMER":-1}	"glycine cleavage system"	
"GCVP-CPLX_RXN"	{"GCVP-CPLX":1,"GCVP-MONOMER":-2}	null	
"GDHA-CPLX_RXN"	{"GDHA-CPLX":1,"GDHA-MONOMER":-6}	"glutamate dehydrogenase"	
"GDPMANDEHYDRA-CPLX_RXN"	{"GDPMANDEHYDRA-CPLX":1,"GDPMANDEHYDRA-MONOMER":-2}	null	
"GLNG-CPLX_RXN"	{"GLNG-CPLX":1,"PROTEIN-NRI":-2}	"DNA-binding transcriptional dual regulator NtrC"	
"GLNL-CPLX_RXN"	{"GLNL-CPLX":1,"PROTEIN-NRII":-2}	"protein histidine kinase NtrB"	
"GLUC1PADENYLTRANS-CPLX_RXN"	{"GLUC1PADENYLTRANS-CPLX":1,"GLUC1PADENYLTRANS-MONOMER":-4}	null	
"GLUCONOKINII-CPLX_RXN"	{"GLUCONOKINII-CPLX":1,"GLUCONOKINII-MONOMER":-2}	"D-gluconate kinase, thermostable"	
"GLUCOSAMINE-6-P-DEAMIN-CPLX_RXN"	{"GLUCOSAMINE-6-P-DEAMIN-CPLX":1,"GLUCOSAMINE-6-P-DEAMIN-MONOMER":-6}	null	
"GLUCOSE-1-PHOSPHAT-CPLX_RXN"	{"GLUCOSE-1-PHOSPHAT-CPLX":1,"GLUCOSE-1-PHOSPHAT-MONOMER":-2}	"glucose-1-phosphatase"	
"GLUTAMATESYN-CPLX_RXN"	{"GLUTAMATESYN-CPLX":1,"GLUTAMATESYN-DIMER":-4}	"glutamate synthase"	
"GLUTAMATESYN-DIMER_RXN"	{"GLUTAMATESYN-DIMER":1,"GLUSYNSMALL-MONOMER":-1,"GLUSYNLARGE-MONOMER":-1}	"glutamate synthase"	
"GLUTAMIDOTRANS-CPLX_RXN"	{"GLUTAMIDOTRANS-CPLX":1,"GLUTAMIDOTRANS-MONOMER":-1,"CYCLASE-MONOMER":-1}	null	
"GLUTAMINESYN-OLIGOMER_RXN"	{"GLUTAMINESYN-OLIGOMER":1,"GLUTAMINESYN-MONOMER":-12}	null	
"GLUTATHIONE-REDUCT-NADPH-CPLX_RXN"	{"GLUTATHIONE-REDUCT-NADPH-CPLX":1,"GLUTATHIONE-REDUCT-NADPH-MONOMER":-2}	null	
"GLUTATHIONE-SYN-CPLX_RXN"	{"GLUTATHIONE-SYN-CPLX":1,"GLUTATHIONE-SYN-MONOMER":-4}	null	
"GLUTDECARBOXA-CPLX_RXN"	{"GLUTDECARBOXA-CPLX":1,"GLUTDECARBOXA-MONOMER":-6}	null	
"GLUTDECARBOXB-CPLX_RXN"	{"GLUTDECARBOXB-CPLX":1,"GLUTDECARBOXB-MONOMER":-6}	null	
"GLUTKIN-CPLX_RXN"	{"GLUTKIN-CPLX":1,"GLUTKIN-MONOMER":-4}	"glutamate 5-kinase"	
"GLUTSEMIALDEHYDROG-CPLX_RXN"	{"GLUTSEMIALDEHYDROG-CPLX":1,"GLUTSEMIALDEHYDROG-MONOMER":-4}	null	
"GLYC3PDEHYDROGBIOSYN-CPLX_RXN"	{"GLYC3PDEHYDROGBIOSYN-CPLX":1,"GLYC3PDEHYDROGBIOSYN-MONOMER":-2}	"glycerol-3-phosphate dehydrogenase, biosynthetic"	
"GLYCDEH-CPLX_RXN"	{"GLYCDEH-CPLX":1,"GLYCDEH-MONOMER":-8}	"L-1,2-propanediol dehydrogenase / glycerol dehydrogenase"	
"GLYCEROL-KIN-CPLX_RXN"	{"GLYCEROL-KIN-CPLX":1,"GLYCEROL-KIN-MONOMER":-4}	null	
"GLYCOPHOSPHORYL-CPLX_RXN"	{"GLYCOPHOSPHORYL-CPLX":1,"GLYCOPHOSPHORYL-MONOMER":-2}	null	
"GLYCPDIESTER-PERI-CPLX_RXN"	{"GLYCPDIESTER-PERI-CPLX":1,"GLYCPDIESTER-PERI-MONOMER":-2}	"glycerophosphoryl diester phosphodiesterase, periplasmic"	
"GLYOCARBOLIG-CPLX_RXN"	{"GLYOCARBOLIG-CPLX":1,"GLYOCARBOLIG-MONOMER":-2}	null	
"GLYOHMETRANS-CPLX_RXN"	{"GLYOHMETRANS-CPLX":1,"GLYOHMETRANS-MONOMER":-2}	"serine hydroxymethyltransferase"	
"GLYOXI-CPLX_RXN"	{"GLYOXI-CPLX":1,"GLYOXI-MONOMER":-2}	"glyoxalase I"	
"GLYS-CPLX_RXN"	{"GLYS-CPLX":1,"GLYS-MONOMER":-2,"GLYQ-MONOMER":-2}	"glycine&mdash;tRNA ligase"	
"GMP-REDUCT-CPLX_RXN"	{"GMP-REDUCT-CPLX":1,"GMP-REDUCT-MONOMER":-4}	null	
"GMP-SYN-CPLX_RXN"	{"GMP-SYN-CPLX":1,"GMP-SYN-MONOMER":-2}	"GMP synthetase"	
"GPT-CPLX_RXN"	{"GPT-CPLX":1,"GPT-MONOMER":-4}	"xanthine-guanine phosphoribosyltransferase"	
"GSAAMINOTRANS-CPLX_RXN"	{"GSAAMINOTRANS-CPLX":1,"GSAAMINOTRANS-MONOMER":-2}	null	
"GSP-CPLX_RXN"	{"GSP-CPLX":1,"GSP-MONOMER":-2}	"fused glutathionylspermidine amidase / glutathionylspermidine synthetase"	
"GST-CPLX_RXN"	{"GST-CPLX":1,"GST-MONOMER":-2}	"glutathione <i>S</i>-transferase GstA"	
"GTP-CYCLOHYDRO-II-CPLX_RXN"	{"GTP-CYCLOHYDRO-II-CPLX":1,"GTP-CYCLOHYDRO-II-MONOMER":-2}	"GTP cyclohydrolase 2"	
"GUANYL-KIN-CPLX_RXN"	{"GUANYL-KIN-CPLX":1,"GUANYL-KIN-MONOMER":-2}	"guanylate kinase"	
"H2PTEROATESYNTH-CPLX_RXN"	{"H2PTEROATESYNTH-CPLX":1,"H2PTEROATESYNTH-MONOMER":-2}	null	
"HCAMULTI-CPLX_RXN"	{"HCAMULTI-CPLX":1,"HCAC-MONOMER":null,"HCAD-MONOMER":null,"HCAA2-MONOMER":null,"PHENYLPRODIOXY-MONOMER":null}	"putative 3-phenylpropionate/cinnamate dioxygenase"	
"HISS-CPLX_RXN"	{"HISS-CPLX":1,"HISS-MONOMER":-2}	null	
"HISTDEHYD-CPLX_RXN"	{"HISTDEHYD-CPLX":1,"HISTDEHYD-MONOMER":-2}	null	
"HISTPHOSTRANS-CPLX_RXN"	{"HISTPHOSTRANS-CPLX":1,"HISTPHOSTRANS-MONOMER":-2}	"histidinol-phosphate aminotransferase"	
"HMP-P-KIN-CPLX_RXN"	{"HMP-P-KIN-CPLX":1,"HMP-P-KIN-MONOMER":-4}	null	
"HOLO-ACP-SYNTH-CPLX_RXN"	{"HOLO-ACP-SYNTH-CPLX":1,"HOLO-ACP-SYNTH-MONOMER":-2}	null	
"HOMOSERKIN-CPLX_RXN"	{"HOMOSERKIN-CPLX":1,"HOMOSERKIN-MONOMER":-2}	"homoserine kinase"	
"HOMSUCTRAN-CPLX_RXN"	{"HOMSUCTRAN-CPLX":1,"HOMSUCTRAN-MONOMER":-2}	null	
"HYDROG3-CPLX_RXN"	{"HYDROG3-CPLX":1,"HYCD-MONOMER":null,"HYCC-MONOMER":null,"HYCF-MONOMER":null,"HYCG-MONOMER":null,"HYCBSMALL-MONOMER":null,"HYCELARGE-MONOMER":null}	"hydrogenase 3"	
"HYDROPEROXIDI-CPLX_RXN"	{"HYDROPEROXIDI-CPLX":1,"HYDROPEROXIDI-MONOMER":-4}	"catalase/hydroperoxidase HPI"	
"HYDROPEROXIDII-CPLX_RXN"	{"HYDROPEROXIDII-CPLX":1,"HYDROPEROXIDII-MONOMER":-4}	"catalase HPII"	
"IMIDHISTID-CPLX_RXN"	{"IMIDHISTID-CPLX":1,"IMIDPHOSPHADEHYDHISTIDPHOSPHA-MONOMER":-2}	null	
"IMP-DEHYDROG-CPLX_RXN"	{"IMP-DEHYDROG-CPLX":1,"IMP-DEHYDROG-MONOMER":-4}	null	
"ISOCIT-LYASE_RXN"	{"ISOCIT-LYASE":1,"ISOCIT-LYASE-MONOMER":-4}	null	
"ISOCITHASE-CPLX_RXN"	{"ISOCITHASE-CPLX":1,"ISOCITDEH-SUBUNIT":-2}	null	
"KDO-8PPHOSPHAT-CPLX_RXN"	{"KDO-8PPHOSPHAT-CPLX":1,"G7663-MONOMER":-4}	"3-deoxy-D-<i>manno</i>-octulosonate 8-phosphate phosphatase KdsC"	
"KDO-8PSYNTH-CPLX_RXN"	{"KDO-8PSYNTH-CPLX":1,"KDO-8PSYNTH-MONOMER":-4}	"3-deoxy-D-<i>manno</i>-octulosonate 8-phosphate synthase"	
"KDPD-CPLX_RXN"	{"KDPD-CPLX":1,"KDPD-MONOMER":-2}	"sensor histidine kinase KdpD"	
"KDPGALDOL-4OH2OXOGLUTARALDOL-CPLX_RXN"	{"KDPGALDOL-4OH2OXOGLUTARALDOL-CPLX":1,"KDPGALDOL-4OH2OXOGLUTARALDOL-MONOMER":-3}	"KHG/KDPG aldolase"	
"L-GLN-FRUCT-6-P-AMINOTRANS-CPLX_RXN"	{"L-GLN-FRUCT-6-P-AMINOTRANS-CPLX":1,"L-GLN-FRUCT-6-P-AMINOTRANS-MONOMER":-2}	"L-glutamine&mdash;D-fructose-6-phosphate aminotransferase"	
"LACTALDREDUCT-CPLX_RXN"	{"LACTALDREDUCT-CPLX":1,"LACTALDREDUCT-MONOMER":-2}	"L-1,2-propanediol oxidoreductase"	
"LDC2-CPLX_RXN"	{"LDC2-CPLX":1,"LDC2-MONOMER":-10}	"lysine decarboxylase 2"	
"LTAA-CPLX_RXN"	{"LTAA-CPLX":1,"LTAA-MONOMER":-4}	"low-specificity L-threonine aldolase"	
"LTARTDEHYDRA-CPLX_RXN"	{"LTARTDEHYDRA-CPLX":1,"TTDA-MONOMER":-2,"TTDB-MONOMER":-2}	null	
"LUMAZINESYN-CPLX_RXN"	{"LUMAZINESYN-CPLX":1,"LUMAZINESYN-MONOMER":-60}	"6,7-dimethyl-8-ribityllumazine synthase"	
"LYSDECARBOX-CPLX_RXN"	{"LYSDECARBOX-CPLX":1,"LYSDECARBOX-MONOMER":-10}	"lysine decarboxylase 1"	
"LYSS-CPLX_RXN"	{"LYSS-CPLX":1,"LYSS-MONOMER":-2}	"lysine&mdash;tRNA ligase, constitutive"	
"LYSU-CPLX_RXN"	{"LYSU-CPLX":1,"LYSU-MONOMER":-2}	null	
"LYXK-CPLX_RXN"	{"LYXK-CPLX":1,"LYXK-MONOMER":-2}	"L-xylulose kinase"	
"MALATE-DEHASE_RXN"	{"MALATE-DEHASE":1,"MALATE-DEHASE-MONOMER":-2}	null	
"MALDEXPHOSPHORYL-CPLX_RXN"	{"MALDEXPHOSPHORYL-CPLX":1,"MALDEXPHOSPHORYL-MONOMER":-2}	null	
"MALIC-NAD-CPLX_RXN"	{"MALIC-NAD-CPLX":1,"MALIC-NAD-MONOMER":-4}	"NAD<sup>+</sup>-dependent malate dehydrogenase"	
"MALIC-NADP-CPLX_RXN"	{"MALIC-NADP-CPLX":1,"MALIC-NADP-MONOMER":-6}	"NADP<sup>+</sup>-dependent malate dehydrogenase"	
"MALTACETYLTRAN-CPLX_RXN"	{"MALTACETYLTRAN-CPLX":1,"MALTACETYLTRAN-MONOMER":-3}	"maltose <i>O</i>-acetyltransferase"	
"MENE-CPLX_RXN"	{"MENE-CPLX":1,"O-SUCCINYLBENZOATE-COA-LIG-MONOMER":-4}	null	
"MENF-CPLX_RXN"	{"MENF-CPLX":1,"MENF-MONOMER":-2}	"isochorismate synthase MenF"	
"METG-CPLX_RXN"	{"METG-CPLX":1,"METG-MONOMER":-2}	null	
"METHGLYSYN-CPLX_RXN"	{"METHGLYSYN-CPLX":1,"METHGLYSYN-MONOMER":-6}	"methylglyoxal synthase"	
"METHYLENETHFREDUCT-CPLX_RXN"	{"METHYLENETHFREDUCT-CPLX":1,"METHYLENETHFREDUCT-MONOMER":-4}	null	
"METNIQ-METHIONINE-ABC-CPLX_RXN"	{"METNIQ-METHIONINE-ABC-CPLX":1,"ABC-MONOMER":-2,"METI-MONOMER":-2,"METQ-MONOMER":-1}	"L-methionine/D-methionine ABC transporter"	
"MUTHLS-CPLX_RXN"	{"MUTHLS-CPLX":1,"EG11281-MONOMER":null,"EG10625-MONOMER":-2,"EG10624-MONOMER":null}	"MutHLS complex, methyl-directed mismatch repair"	
"N-ACETYLTRANSFER-CPLX_RXN"	{"N-ACETYLTRANSFER-CPLX":1,"N-ACETYLTRANSFER-MONOMER":-6}	"N-acetylglutamate synthase"	
"NAD-SYNTH-CPLX_RXN"	{"NAD-SYNTH-CPLX":1,"NAD-SYNTH-MONOMER":-2}	"NH<sub>3</sub>-dependent NAD<sup>+</sup> synthetase"	
"NADH-DHI-CPLX_RXN"	{"NADH-DHI-CPLX":1,"NUOA-MONOMER":-1,"NUOH-MONOMER":-1,"NUOJ-MONOMER":-1,"NUOK-MONOMER":-1,"NUOL-MONOMER":-1,"NUOM-MONOMER":-1,"NUON-MONOMER":-1,"CPLX0-3361":-1}	"NADH:quinone oxidoreductase I"	
"NAG1P-URIDYLTRANS-CPLX_RXN"	{"NAG1P-URIDYLTRANS-CPLX":1,"NAG1P-URIDYLTRANS-MONOMER":-3}	"fused N-acetylglucosamine-1-phosphate uridyltransferase and glucosamine-1-phosphate acetyltransferase"	
"NAG6PDEACET-CPLX_RXN"	{"NAG6PDEACET-CPLX":1,"NAG6PDEACET-MONOMER":-4}	null	
"NAP-CPLX_RXN"	{"NAP-CPLX":1,"NAPB-MONOMER":-1,"NAPA-MONOMER":-1}	"periplasmic nitrate reductase"	
"NARQ-CPLX_RXN"	{"NARQ-CPLX":1,"NARQ-MONOMER":-2}	"sensory histidine kinase NarQ"	
"NARX-CPLX_RXN"	{"NARX-CPLX":1,"NARX-MONOMER":-2}	"sensory histidine kinase NarX"	
"NITRATREDUCTA-CPLX_RXN"	{"NITRATREDUCTA-CPLX":1,"NARG-MONOMER":-2,"NARH-MONOMER":-2,"NARI-MONOMER":-2}	"nitrate reductase A"	
"NITRATREDUCTZ-CPLX_RXN"	{"NITRATREDUCTZ-CPLX":1,"NARY-MONOMER":-1,"NARZ-MONOMER":-1,"NARV-MONOMER":-1}	"nitrate reductase Z"	
"NITRITREDUCT-CPLX_RXN"	{"NITRITREDUCT-CPLX":1,"NIRD-MONOMER":null,"NIRB-MONOMER":null}	null	
"NQOR-CPLX_RXN"	{"NQOR-CPLX":1,"NQOR-MONOMER":-2}	null	
"NRDACTMULTI-CPLX_RXN"	{"NRDACTMULTI-CPLX":1,"RIBONUCLEOSIDE-TRIP-REDUCT-CPLX":null,"CPLX0-229":null}	"anaerobic nucleoside-triphosphate reductase activating system"	
"NRDE-CPLX_RXN"	{"NRDE-CPLX":1,"NRDE-MONOMER":-2}	"ribonucleoside-diphosphate reductase 2, &alpha; subunit dimer"	
"NRDF-CPLX_RXN"	{"NRDF-CPLX":1,"NRDF-MONOMER":-2}	"ribonucleoside-diphosphate reductase 2, &beta; subunit dimer"	
"NRFMULTI-CPLX_RXN"	{"NRFMULTI-CPLX":1,"CYTOCHROMEC552-MONOMER":-1,"CYTOCHROMEC-MONOMER":-1}	"periplasmic nitrite reductase NrfAB"	
"NUCLEOSIDE-DIP-KIN-CPLX_RXN"	{"NUCLEOSIDE-DIP-KIN-CPLX":1,"NUCLEOSIDE-DIP-KIN-MONOMER":-4}	"nucleoside diphosphate kinase"	
"O-SUCCHOMOSERLYASE-CPLX_RXN"	{"O-SUCCHOMOSERLYASE-CPLX":1,"O-SUCCHOMOSERLYASE-MONOMER":-4}	null	
"ORNCARBAMTRANSFERF-CPLX_RXN"	{"ORNCARBAMTRANSFERF-CPLX":1,"CHAINF-MONOMER":-3}	"ornithine carbamoyltransferase"	
"ORNCARBAMTRANSFERI-CPLX_RXN"	{"ORNCARBAMTRANSFERI-CPLX":1,"CHAINI-MONOMER":-3}	"ornithine carbamoyltransferase"	
"ORNDECARBOX-BIO-CPLX_RXN"	{"ORNDECARBOX-BIO-CPLX":1,"ORNDECARBOX-BIO-MONOMER":-2}	"constitutive ornithine decarboxylase"	
"ORNDECARBOXDEG-CPLX_RXN"	{"ORNDECARBOXDEG-CPLX":1,"ORNDECARBOXDEG-MONOMER":-2}	"inducible ornithine decarboxylase"	
"OROPRIBTRANS-CPLX_RXN"	{"OROPRIBTRANS-CPLX":1,"OROPRIBTRANS-MONOMER":-2}	null	
"OROTPDECARB-CPLX_RXN"	{"OROTPDECARB-CPLX":1,"OROTPDECARB-MONOMER":-2}	null	
"PABASYN-CPLX_RXN"	{"PABASYN-CPLX":1,"PABASYN-COMPI-MONOMER":-1,"PABASYN-COMPII-MONOMER":-1}	null	
"PANTOATE-BETA-ALANINE-LIG-CPLX_RXN"	{"PANTOATE-BETA-ALANINE-LIG-CPLX":1,"PANTOATE-BETA-ALANINE-LIG-MONOMER":-2}	null	
"PANTOTHENATE-KIN-CPLX_RXN"	{"PANTOTHENATE-KIN-CPLX":1,"PANTOTHENATE-KIN-MONOMER":-2}	null	
"PAPSSULFOTRANS-CPLX_RXN"	{"PAPSSULFOTRANS-CPLX":1,"PAPSSULFOTRANS-MONOMER":-2}	null	
"PC00003_RXN"	{"PC00003":1,"PD00242":-2}	"DNA-binding transcriptional dual regulator AraC"	
"PC00004_RXN"	{"PC00004":1,"PD00257":-2}	"DNA-binding transcriptional dual regulator CRP"	
"PC00005_RXN"	{"PC00005":1,"PD00194":-6}	"DNA-binding transcriptional dual regulator ArgR"	
"PC00007_RXN"	{"PC00007":1,"PD00423":-2}	"DNA-binding transcriptional repressor TrpR"	
"PC00010_RXN"	{"PC00010":1,"PD00205":-2}	"DNA-binding transcriptional repressor LexA"	
"PC00027_RXN"	{"PC00027":1,"PD00347":null,"PD00348":null}	"DNA-binding transcriptional dual regulator IHF"	
"PC00033_RXN"	{"PC00033":1,"PD00219":-2}	"DNA-binding transcriptional repressor PurR"	
"PC00040_RXN"	{"PC00040":1,"PD00232":-4}	"DNA-binding transcriptional dual regulator CysB"	
"PC00061_RXN"	{"PC00061":1,"PD00521":-4}	"DNA-binding transcriptional dual regulator Cra"	
"PC00084_RXN"	{"PC00084":1,"RCSB-MONOMER":-1,"PD02233":-1}	"RcsAB DNA-binding transcriptional dual regulator"	
"PC00086_RXN"	{"PC00086":1,"PD00221":-2}	"transcriptional activator RhaS"	
"PC00103_RXN"	{"PC00103":1,"PD01103":-2}	"DNA-binding transcriptional repressor MngR"	
"PDXH-CPLX_RXN"	{"PDXH-CPLX":1,"PDXH-MONOMER":-2}	null	
"PDXK-CPLX_RXN"	{"PDXK-CPLX":1,"PDXK-MONOMER":-2}	"pyridoxal kinase I / hydroxymethylpyrimidine kinase"	
"PEPCARBOX-CPLX_RXN"	{"PEPCARBOX-CPLX":1,"PEPCARBOX-MONOMER":-4}	null	
"PEPSYNTH-CPLX_RXN"	{"PEPSYNTH-CPLX":1,"PEPSYNTH-MONOMER":-2}	"phosphoenolpyruvate synthetase"	
"PGLYCDEHYDROG-CPLX_RXN"	{"PGLYCDEHYDROG-CPLX":1,"PGLYCDEHYDROG-MONOMER":-4}	"phosphoglycerate dehydrogenase"	
"PHENDEHYD-CPLX_RXN"	{"PHENDEHYD-CPLX":1,"PHENDEHYD-MONOMER":-4}	null	
"PHES-CPLX_RXN"	{"PHES-CPLX":1,"PHES-MONOMER":-2,"PHET-MONOMER":-2}	"phenylalanine&mdash;tRNA ligase"	
"PHOR-CPLX_RXN"	{"PHOR-CPLX":1,"PHOR-MONOMER":-2}	"sensor histidine kinase PhoR"	
"PHOSACETYLTRANS-CPLX_RXN"	{"PHOSACETYLTRANS-CPLX":1,"PHOSACETYLTRANS-MONOMER":-6}	"phosphate acetyltransferase"	
"PHOSGLYCMUTASE_RXN"	{"PHOSGLYCMUTASE":1,"GPMA-MONOMER":-2}	"2,3-bisphosphoglycerate-dependent phosphoglycerate mutase"	
"PHOSPHASERDECARB-DIMER_RXN"	{"PHOSPHASERDECARB-DIMER":1,"PHOSPHASERDECARB-BETA-MONOMER":-2,"PHOSPHASERDECARB-ALPHA-MONOMER":-2}	"phosphatidylserine decarboxylase"	
"PII2-CPLX_RXN"	{"PII2-CPLX":1,"PROTEIN-PII2":-3}	"nitrogen regulatory protein PII-2"	
"PIIPROTEIN-CPLX_RXN"	{"PIIPROTEIN-CPLX":1,"PROTEIN-PII":-3}	"nitrogen regulatory protein PII-1"	
"PKI-COMPLEX_RXN"	{"PKI-COMPLEX":1,"PKI-MONOMER":-4}	"pyruvate kinase I"	
"PKII-CPLX_RXN"	{"PKII-CPLX":1,"PKII-MONOMER":-4}	"pyruvate kinase II"	
"PORPHOBILSYNTH-CPLX_RXN"	{"PORPHOBILSYNTH-CPLX":1,"PORPHOBILSYNTH-MONOMER":-8}	null	
"PPK-CPLX_RXN"	{"PPK-CPLX":1,"PPK-MONOMER":-2}	null	
"PPPGPPHYDRO-CPLX_RXN"	{"PPPGPPHYDRO-CPLX":1,"PPPGPPHYDRO-MONOMER":-2}	null	
"PPX-CPLX_RXN"	{"PPX-CPLX":1,"PPX-MONOMER":-2}	null	
"PROS-CPLX_RXN"	{"PROS-CPLX":1,"PROS-MONOMER":-2}	null	
"PRPPAMIDOTRANS-CPLX_RXN"	{"PRPPAMIDOTRANS-CPLX":1,"PRPPAMIDOTRANS-MONOMER":-4}	null	
"PSERTRANSAM-CPLX_RXN"	{"PSERTRANSAM-CPLX":1,"PSERTRANSAM-MONOMER":-2}	"phosphoserine/phosphohydroxythreonine aminotransferase"	
"PURE-CPLX_RXN"	{"PURE-CPLX":1,"PURE-MONOMER":-8}	"<i>N<sup>5</sup></i>-carboxyaminoimidazole ribonucleotide mutase"	
"PURK-CPLX_RXN"	{"PURK-CPLX":1,"PURK-MONOMER":-2}	null	
"PUTA-CPLX_RXN"	{"PUTA-CPLX":1,"PUTA-MONOMER":-2}	"fused DNA-binding transcriptional repressor / proline dehydrogenase / 1-pyrroline-5-carboxylate dehydrogenase PutA"	
"PYRNUTRANSHYDROGEN-CPLX_RXN"	{"PYRNUTRANSHYDROGEN-CPLX":1,"PNTB-MONOMER":-2,"PNTA-MONOMER":-2}	null	
"PYRROLINECARBREDUCT-CPLX_RXN"	{"PYRROLINECARBREDUCT-CPLX":1,"PYRROLINECARBREDUCT-MONOMER":-10}	null	
"PYRUVATEDEH-CPLX_RXN"	{"PYRUVATEDEH-CPLX":1,"E1P-CPLX":-12,"E2P-MONOMER":-24,"E3-CPLX":-6}	null	
"PYRUVFORMLY-INACTIVE-CPLX_RXN"	{"PYRUVFORMLY-INACTIVE-CPLX":1,"PYRUVFORMLY-MONOMER":-2}	"pyruvate formate-lyase (inactive)"	
"PYRUVOXID-CPLX_RXN"	{"PYRUVOXID-CPLX":1,"PYRUVOXID-MONOMER":-4}	"pyruvate oxidase"	
"QOR-CPLX_RXN"	{"QOR-CPLX":1,"QOR-MONOMER":-2}	"putative quinone oxidoreductase 1"	
"QUINOPRIBOTRANS-CPLX_RXN"	{"QUINOPRIBOTRANS-CPLX":1,"QUINOPRIBOTRANS-MONOMER":-2}	"quinolinate phosphoribosyltransferase (decarboxylating)"	
"RECBCD_RXN"	{"RECBCD":1,"EG10826-MONOMER":-1,"EG10825-MONOMER":-1,"EG10824-MONOMER":-1}	"exodeoxyribonuclease V"	
"RECFOR-CPLX_RXN"	{"RECFOR-CPLX":1,"EG10828-MONOMER":null,"EG10834-MONOMER":null,"EG10832-MONOMER":null}	"RecFOR complex"	
"RHAMNULPALDOL-CPLX_RXN"	{"RHAMNULPALDOL-CPLX":1,"RHAMNULPALDOL-MONOMER":-4}	null	
"RIB5PISOMA-CPLX_RXN"	{"RIB5PISOMA-CPLX":1,"RIB5PISOMA-MONOMER":-2}	"ribose-5-phosphate isomerase A"	
"RIB5PISOMB-CPLX_RXN"	{"RIB5PISOMB-CPLX":1,"RIB5PISOMB-MONOMER":-2}	"allose-6-phosphate isomerase / ribose-5-phosphate isomerase B"	
"RIBONUCLEOSIDE-DIP-REDUCTI-CPLX_RXN"	{"RIBONUCLEOSIDE-DIP-REDUCTI-CPLX":1,"B1-CPLX":-1,"B2-CPLX":-1}	"ribonucleoside-diphosphate reductase 1"	
"RIBONUCLEOSIDE-DIP-REDUCTII-CPLX_RXN"	{"RIBONUCLEOSIDE-DIP-REDUCTII-CPLX":1,"NRDE-CPLX":-1,"NRDF-CPLX":-1}	"ribonucleoside-diphosphate reductase 2"	
"RIBONUCLEOSIDE-TRIP-REDUCT-CPLX_RXN"	{"RIBONUCLEOSIDE-TRIP-REDUCT-CPLX":1,"RIBONUCLEOSIDE-TRIP-REDUCT-MONOMER":-2}	"anaerobic ribonucleoside-triphosphate reductase"	
"RIBULOKIN-CPLX_RXN"	{"RIBULOKIN-CPLX":1,"RIBULOKIN-MONOMER":-2}	null	
"RIBULPEPIM-CPLX_RXN"	{"RIBULPEPIM-CPLX":1,"RIBULPEPIM-MONOMER":-4}	"L-ribulose-5-phosphate 4-epimerase AraD"	
"RNAP32-CPLX_RXN"	{"RNAP32-CPLX":1,"APORNAP-CPLX":-1,"RPOH-MONOMER":-1}	"RNA polymerase sigma 32"	
"RNAP54-CPLX_RXN"	{"RNAP54-CPLX":1,"APORNAP-CPLX":-1,"RPON-MONOMER":-1}	"RNA polymerase sigma 54"	
"RNAP70-CPLX_RXN"	{"RNAP70-CPLX":1,"APORNAP-CPLX":-1,"RPOD-MONOMER":-1}	"RNA polymerase sigma 70"	
"RNAPE-CPLX_RXN"	{"RNAPE-CPLX":1,"APORNAP-CPLX":-1,"RPOE-MONOMER":-1}	"RNA polymerase sigma 24"	
"RNAPS-CPLX_RXN"	{"RNAPS-CPLX":1,"APORNAP-CPLX":-1,"RPOS-MONOMER":-1}	"RNA polymerase sigma S"	
"RUVABC-CPLX_RXN"	{"RUVABC-CPLX":1,"EG10925-MONOMER":-2,"EG10924-MONOMER":-12,"EG10923-MONOMER":-4}	"resolvasome"	
"S-ADENMETSYN-CPLX_RXN"	{"S-ADENMETSYN-CPLX":1,"S-ADENMETSYN-MONOMER":-4}	"methionine adenosyltransferase"	
"SAICARSYN-CPLX_RXN"	{"SAICARSYN-CPLX":1,"SAICARSYN-MONOMER":-3}	null	
"SAMDECARB-CPLX_RXN"	{"SAMDECARB-CPLX":1,"SAMDC-ALPHA-MONOMER":-4,"SAMDC-BETA-MONOMER":-4}	null	
"SEC-SECRETION-CPLX_RXN"	{"SEC-SECRETION-CPLX":1,"SECD-SECF-YAJC-YIDC-CPLX":null,"SECE-G-Y-CPLX":null,"YIDC":null}	"Sec Holo-Translocon"	
"SECD-SECF-YAJC-YIDC-CPLX_RXN"	{"SECD-SECF-YAJC-YIDC-CPLX":1,"SECD":null,"SECF":null,"EG11096-MONOMER":null}	"Sec translocon accessory complex"	
"SECE-G-Y-CPLX_RXN"	{"SECE-G-Y-CPLX":1,"SECE":null,"SECG":null,"SECY":null}	"SecYEG translocon"	
"SERS-CPLX_RXN"	{"SERS-CPLX":1,"SERS-MONOMER":-2}	"serine&mdash;tRNA ligase"	
"SIROHEMESYN-CPLX_RXN"	{"SIROHEMESYN-CPLX":1,"SIROHEMESYN-MONOMER":-2}	"siroheme synthase"	
"SORB6PDEHYDROG-CPLX_RXN"	{"SORB6PDEHYDROG-CPLX":1,"SORB6PDEHYDROG-MONOMER":-4}	null	
"SPERMACTRAN-CPLX_RXN"	{"SPERMACTRAN-CPLX":1,"SPERMACTRAN-MONOMER":-4}	"spermidine <i>N</i>-acetyltransferase"	
"SPERMIDINESYN-CPLX_RXN"	{"SPERMIDINESYN-CPLX":1,"SPERMIDINESYN-MONOMER":-2}	"spermidine synthase"	
"SUCC-DEHASE_RXN"	{"SUCC-DEHASE":1,"SDH-FLAVO":-1,"SDH-FE-S":-1,"SDH-MEMB1":-1,"SDH-MEMB2":-1}	"succinate:quinone oxidoreductase subcomplex"	
"SUCCCOASYN_RXN"	{"SUCCCOASYN":1,"SUCCCOASYN-ALPHA":-2,"SUCCCOASYN-BETA":-2}	null	
"SUCCORNTRANSAM-CPLX_RXN"	{"SUCCORNTRANSAM-CPLX":1,"SUCCORNTRANSAM-MONOMER":-2}	"succinylornithine transaminase"	
"SULFATE-ADENYLYLTRANS-CPLX_RXN"	{"SULFATE-ADENYLYLTRANS-CPLX":1,"CYSD-MONOMER":-4,"CYSN-MONOMER":-4}	"sulfate adenylyltransferase"	
"SULFITE-REDUCT-CPLX_RXN"	{"SULFITE-REDUCT-CPLX":1,"CPLX0-7841":-1,"BETACOMP-MONOMER":-4}	"assimilatory sulfite reductase (NADPH)"	
"SUPEROX-DISMUTFE-CPLX_RXN"	{"SUPEROX-DISMUTFE-CPLX":1,"SUPEROX-DISMUTFE-MONOMER":-2}	"superoxide dismutase (Fe)"	
"SUPEROX-DISMUTMN-CPLX_RXN"	{"SUPEROX-DISMUTMN-CPLX":1,"SUPEROX-DISMUTMN-MONOMER":-2}	"superoxide dismutase (Mn)"	
"TAP-CPLX_RXN"	{"TAP-CPLX":1,"CHEA-CPLX":-1,"CHEW-MONOMER":-2,"CPLX0-8104":-6}	"chemotaxis signaling complex - dipeptide sensing"	
"TAR-CPLX_RXN"	{"TAR-CPLX":1,"CHEA-CPLX":-1,"CHEW-MONOMER":-2,"CPLX0-8102":-6}	"chemotaxis signaling complex - aspartate sensing"	
"TATABCE-CPLX_RXN"	{"TATABCE-CPLX":1,"G7808-MONOMER":null,"EG11479-MONOMER":null,"EG11305-MONOMER":null,"TATA":null}	"twin arginine protein translocation system"	
"THIOESTERII-CPLX_RXN"	{"THIOESTERII-CPLX":1,"THIOESTERII-MONOMER":-4}	"acyl-CoA thioesterase II"	
"THIOREDOXIN-REDUCT-NADPH-CPLX_RXN"	{"THIOREDOXIN-REDUCT-NADPH-CPLX":1,"THIOREDOXIN-REDUCT-NADPH-MONOMER":-2}	null	
"THREDEHYDCAT-CPLX_RXN"	{"THREDEHYDCAT-CPLX":1,"THREDEHYDCAT-MONOMER":-4}	"catabolic threonine dehydratase"	
"THREDEHYDSYN-CPLX_RXN"	{"THREDEHYDSYN-CPLX":1,"THREDEHYDSYN-MONOMER":-4}	"threonine deaminase"	
"THREODEHYD-CPLX_RXN"	{"THREODEHYD-CPLX":1,"THREODEHYD-MONOMER":-4}	null	
"THRS-CPLX_RXN"	{"THRS-CPLX":1,"THRS-MONOMER":-2}	null	
"THYMIDYLATESYN-CPLX_RXN"	{"THYMIDYLATESYN-CPLX":1,"THYMIDYLATESYN-MONOMER":-2}	null	
"TMAOREDUCTI-CPLX_RXN"	{"TMAOREDUCTI-CPLX":1,"EG11815-MONOMER":null,"TORA-MONOMER":null}	"menaquinol:trimethylamine <i>N</i>-oxide oxidoreductase I"	
"TORR-CPLX_RXN"	{"TORR-CPLX":1,"TORR-MONOMER":-2}	"DNA-binding transcriptional dual regulator TorR"	
"TORS-CPLX_RXN"	{"TORS-CPLX":1,"TORS-MONOMER":-2}	"sensory histidine kinase TorS"	
"TPI_RXN"	{"TPI":1,"TPI-MONOMER":-2}	null	
"TRANS-200-CPLX_RXN"	{"TRANS-200-CPLX":1,"CPLX0-7964":-1,"MACB":-2,"MACA":-6}	"ABC-type tripartite efflux pump"	
"TRANS-CPLX-201_RXN"	{"TRANS-CPLX-201":1,"CPLX0-7964":-1,"EG11703-MONOMER":-6,"ACRB-MONOMER":-3}	"multidrug efflux pump AcrAB-TolC"	
"TRANS-CPLX-202_RXN"	{"TRANS-CPLX-202":1,"CPLX0-7964":-1,"B2076-MONOMER":-1,"B2075-MONOMER":-2,"MDTA":-1}	"multidrug efflux pump MdtABC-TolC"	
"TRANS-CPLX-203_RXN"	{"TRANS-CPLX-203":1,"EG12283-MONOMER":-1,"EG12282-MONOMER":-1,"MONOMER0-422":-1}	null	
"TRANS-CPLX-204_RXN"	{"TRANS-CPLX-204":1,"CPLX0-7964":-1,"EG12240-MONOMER":-1,"YHIV-MONOMER":-1}	"multidrug efflux pump MdtEF-TolC"	
"TRANSALDOLB-CPLX_RXN"	{"TRANSALDOLB-CPLX":1,"TRANSALDOLB-MONOMER":-2}	"transaldolase B"	
"TRANSENOYLCOARED-CPLX_RXN"	{"TRANSENOYLCOARED-CPLX":1,"TRANSENOYLCOARED-MONOMER":-2}	null	
"TRANSKETOI-CPLX_RXN"	{"TRANSKETOI-CPLX":1,"TRANSKETOI-MONOMER":-2}	"transketolase 1"	
"TRG-CPLX_RXN"	{"TRG-CPLX":1,"CHEA-CPLX":-1,"CHEW-MONOMER":-2,"CPLX0-8105":-6}	"chemotaxis signaling complex - ribose/galactose/glucose sensing"	
"TRPS-CPLX_RXN"	{"TRPS-CPLX":1,"TRPS-MONOMER":-2}	null	
"TRYPSYN_RXN"	{"TRYPSYN":1,"TRYPSYN-APROTEIN":-2,"CPLX0-2401":-1}	null	
"TRYPTOPHAN-CPLX_RXN"	{"TRYPTOPHAN-CPLX":1,"TRYPTOPHAN-MONOMER":-4}	null	
"TSR-CPLX_RXN"	{"TSR-CPLX":1,"CHEW-MONOMER":-2,"CHEA-CPLX":-1,"CPLX0-8103":-6}	"chemotaxis signaling complex - serine sensing"	
"TYRB-DIMER_RXN"	{"TYRB-DIMER":1,"TYRB-MONOMER":-2}	"tyrosine aminotransferase"	
"TYRS-CPLX_RXN"	{"TYRS-CPLX":1,"TYRS-MONOMER":-2}	null	
"UDHA-CPLX_RXN"	{"UDHA-CPLX":1,"UDHA-MONOMER":-8}	"soluble pyridine nucleotide transhydrogenase"	
"UDPGLUCEPIM-CPLX_RXN"	{"UDPGLUCEPIM-CPLX":1,"UDPGLUCEPIM-MONOMER":-2}	null	
"UDPNACETYLGLUCOSAMACYLTRANS-CPLX_RXN"	{"UDPNACETYLGLUCOSAMACYLTRANS-CPLX":1,"UDPNACETYLGLUCOSAMACYLTRANS-MONOMER":-3}	"acyl-[acyl-carrier-protein]&mdash;UDP-<i>N</i>-acetylglucosamine <i>O</i>-acyltransferase"	
"UMPKI-CPLX_RXN"	{"UMPKI-CPLX":1,"UMPKI-MONOMER":-6}	"UMP kinase"	
"UPPSYN-CPLX_RXN"	{"UPPSYN-CPLX":1,"UPPSYN-MONOMER":-2}	"<i>ditrans,polycis</i>-undecaprenyl-diphosphate synthase [(2<i>E</i>,6<i>E</i>)-farnesyl-diphosphate specific]"	
"URACIL-PRIBOSYLTRANS-CPLX_RXN"	{"URACIL-PRIBOSYLTRANS-CPLX":1,"URACIL-PRIBOSYLTRANS-MONOMER":-3}	null	
"URPHOS-CPLX_RXN"	{"URPHOS-CPLX":1,"URPHOS-MONOMER":-6}	null	
"UVRABC-CPLX_RXN"	{"UVRABC-CPLX":1,"EG11062-MONOMER":null,"EG11063-MONOMER":null,"EG11061-MONOMER":null}	"excision nuclease UvrABC"	
"XANTHOSINEPHOSPHORY-CPLX_RXN"	{"XANTHOSINEPHOSPHORY-CPLX":1,"XANTHOSINEPHOSPHORY-MONOMER":-6}	"xanthosine phosphorylase"	
"XYLISOM-CPLX_RXN"	{"XYLISOM-CPLX":1,"XYLISOM-MONOMER":-2}	null	
"YDGEF-CPLX_RXN"	{"YDGEF-CPLX":1,"B1600-MONOMER":null,"B1599-MONOMER":null}	"multidrug/spermidine efflux pump"	
"CPLX0-1041_RXN"	{"CPLX0-1041":1,"CSRB-RNA":-1,"EG11447-MONOMER":-18}	"CsrA complex with CsrB RNA"	
"CPLX0-1382_RXN"	{"CPLX0-1382":1,"RNPB-RNA":-1,"EG10862-MONOMER":-1}	"RNase P"	
"CPLX0-3953_RXN"	{"CPLX0-3953":1,"RRSA-RRNA":null,"EG10900-MONOMER":null,"EG10901-MONOMER":null,"EG10902-MONOMER":null,"EG10903-MONOMER":null,"EG10904-MONOMER":null,"EG10905-MONOMER":null,"EG10906-MONOMER":null,"EG10907-MONOMER":null,"EG10908-MONOMER":null,"EG10909-MONOMER":null,"EG10910-MONOMER":null,"EG10911-MONOMER":null,"EG10912-MONOMER":null,"EG10913-MONOMER":null,"EG10914-MONOMER":null,"EG10915-MONOMER":null,"EG10916-MONOMER":null,"EG10917-MONOMER":null,"EG10918-MONOMER":null,"EG10919-MONOMER":null,"EG10920-MONOMER":null,"EG11508-MONOMER":null}	"30S ribosomal subunit"	
"CPLX0-3962_RXN"	{"CPLX0-3962":1,"RRLA-RRNA":null,"RRFA-RRNA":null,"EG10864-MONOMER":null,"EG10865-MONOMER":null,"EG10866-MONOMER":null,"EG10867-MONOMER":null,"EG10868-MONOMER":null,"EG10869-MONOMER":null,"CPLX0-3956":null,"EG10870-MONOMER":null,"EG10872-MONOMER":null,"EG10874-MONOMER":null,"EG10875-MONOMER":null,"EG10876-MONOMER":null,"EG10877-MONOMER":null,"EG10878-MONOMER":null,"EG10879-MONOMER":null,"EG10880-MONOMER":null,"EG10881-MONOMER":null,"EG50001-MONOMER":null,"EG10882-MONOMER":null,"EG10883-MONOMER":null,"EG10884-MONOMER":null,"EG10885-MONOMER":null,"EG50002-MONOMER":null,"EG10886-MONOMER":null,"EG10887-MONOMER":null,"EG10888-MONOMER":null,"EG10889-MONOMER":null,"EG10890-MONOMER":null,"EG10891-MONOMER":null,"EG10892-MONOMER":null,"EG11231-MONOMER":null,"EG11232-MONOMER":null}	"50S ribosomal subunit"	
"CPLX0-3964_RXN"	{"CPLX0-3964":1,"CPLX0-3953":-1,"CPLX0-3962":-1}	"ribosome"	
"CPLX0-8028_RXN"	{"CPLX0-8028":1,"IS061-RNA":null,"CPLX0-7956":null}	"CsrA complex with McaS RNA"	
"CPLX0-8053_RXN"	{"CPLX0-8053":1,"EG10942-MONOMER":null}	"SelB-L-selenocysteinyl-tRNA<sup>sec</sup>"	
"CPLX0-8253_RXN"	{"CPLX0-8253":1,"CSRC-RNA":-1,"EG11447-MONOMER":-9}	"CsrA complex with CsrC RNA"	
"SRP-CPLX_RXN"	{"SRP-CPLX":1,"EG10300-MONOMER":null,"FFS-RNA":null}	"Signal Recognition Particle"	
# Reactions below were added to save some 1CS reactions
"CPLX0-7796APO_RXN"	{"CPLX0-7796APO": 1, "PD04032": -2}	null
# Reactions below were added to save some 2CS reactions
"ARCB-CPLX_RXN"	{"ARCB-CPLX": 1, "ARCB-MONOMER": -2}	null
