# Organism: Escherichia coli K-12 substr. MG1655
# Database: EcoCyc
# Version: 26.0
# Date and time generated: April 20, 2022, 16:50:36
"id"	"stoichiometry"	"catalyzed_by"	"common_name"
"ALANINE--TRNA-LIGASE-RXN_alaT-tRNA"	{"L-ALPHA-ALANINE": -1, "ATP": -1, "alaT-tRNA": -1, "PPI": 1, "AMP": 1, "charged-alaT-tRNA": 1}	["ALAS-CPLX"]	"ALANYL-TRNA SYNTHETASE"
"ALANINE--TRNA-LIGASE-RXN_alaU-tRNA"	{"L-ALPHA-ALANINE": -1, "ATP": -1, "alaU-tRNA": -1, "PPI": 1, "AMP": 1, "charged-alaU-tRNA": 1}	["ALAS-CPLX"]	"ALANYL-TRNA SYNTHETASE"
"ALANINE--TRNA-LIGASE-RXN_alaV-tRNA"	{"L-ALPHA-ALANINE": -1, "ATP": -1, "alaV-tRNA": -1, "PPI": 1, "AMP": 1, "charged-alaV-tRNA": 1}	["ALAS-CPLX"]	"ALANYL-TRNA SYNTHETASE"
"ALANINE--TRNA-LIGASE-RXN_alaW-tRNA"	{"L-ALPHA-ALANINE": -1, "ATP": -1, "alaW-tRNA": -1, "PPI": 1, "AMP": 1, "charged-alaW-tRNA": 1}	["ALAS-CPLX"]	"ALANYL-TRNA SYNTHETASE"
"ALANINE--TRNA-LIGASE-RXN_alaX-tRNA"	{"L-ALPHA-ALANINE": -1, "ATP": -1, "alaX-tRNA": -1, "PPI": 1, "AMP": 1, "charged-alaX-tRNA": 1}	["ALAS-CPLX"]	"ALANYL-TRNA SYNTHETASE"
"ARGININE--TRNA-LIGASE-RXN_argQ-tRNA"	{"ARG": -1, "ATP": -1, "argQ-tRNA": -1, "PPI": 1, "AMP": 1, "charged-argQ-tRNA": 1}	["ARGS-MONOMER"]	"ARGINYL-TRNA SYNTHETASE"
"ARGININE--TRNA-LIGASE-RXN_argU-tRNA"	{"ARG": -1, "ATP": -1, "argU-tRNA": -1, "PPI": 1, "AMP": 1, "charged-argU-tRNA": 1}	["ARGS-MONOMER"]	"ARGINYL-TRNA SYNTHETASE"
"ARGININE--TRNA-LIGASE-RXN_argV-tRNA"	{"ARG": -1, "ATP": -1, "argV-tRNA": -1, "PPI": 1, "AMP": 1, "charged-argV-tRNA": 1}	["ARGS-MONOMER"]	"ARGINYL-TRNA SYNTHETASE"
"ARGININE--TRNA-LIGASE-RXN_argW-tRNA"	{"ARG": -1, "ATP": -1, "argW-tRNA": -1, "PPI": 1, "AMP": 1, "charged-argW-tRNA": 1}	["ARGS-MONOMER"]	"ARGINYL-TRNA SYNTHETASE"
"ARGININE--TRNA-LIGASE-RXN_argX-tRNA"	{"ARG": -1, "ATP": -1, "argX-tRNA": -1, "PPI": 1, "AMP": 1, "charged-argX-tRNA": 1}	["ARGS-MONOMER"]	"ARGINYL-TRNA SYNTHETASE"
"ARGININE--TRNA-LIGASE-RXN_argY-tRNA"	{"ARG": -1, "ATP": -1, "argY-tRNA": -1, "PPI": 1, "AMP": 1, "charged-argY-tRNA": 1}	["ARGS-MONOMER"]	"ARGINYL-TRNA SYNTHETASE"
"ARGININE--TRNA-LIGASE-RXN_argZ-tRNA"	{"ARG": -1, "ATP": -1, "argZ-tRNA": -1, "PPI": 1, "AMP": 1, "charged-argZ-tRNA": 1}	["ARGS-MONOMER"]	"ARGINYL-TRNA SYNTHETASE"
"ASPARAGINE--TRNA-LIGASE-RXN_asnT-tRNA"	{"ASN": -1, "ATP": -1, "asnT-tRNA": -1, "PPI": 1, "AMP": 1, "charged-asnT-tRNA": 1}	["ASNS-CPLX"]	"ASPARAGINYL-TRNA SYNTHETASE"
"ASPARAGINE--TRNA-LIGASE-RXN_asnU-tRNA"	{"ASN": -1, "ATP": -1, "asnU-tRNA": -1, "PPI": 1, "AMP": 1, "charged-asnU-tRNA": 1}	["ASNS-CPLX"]	"ASPARAGINYL-TRNA SYNTHETASE"
"ASPARAGINE--TRNA-LIGASE-RXN_asnV-tRNA"	{"ASN": -1, "ATP": -1, "asnV-tRNA": -1, "PPI": 1, "AMP": 1, "charged-asnV-tRNA": 1}	["ASNS-CPLX"]	"ASPARAGINYL-TRNA SYNTHETASE"
"ASPARAGINE--TRNA-LIGASE-RXN_RNA0-304"	{"ASN": -1, "ATP": -1, "RNA0-304": -1, "PPI": 1, "AMP": 1, "RNA0-310": 1}	["ASNS-CPLX"]	"ASPARAGINYL-TRNA SYNTHETASE"
"ASPARTATE--TRNA-LIGASE-RXN_aspT-tRNA"	{"L-ASPARTATE": -1, "ATP": -1, "aspT-tRNA": -1, "PPI": 1, "AMP": 1, "charged-aspT-tRNA": 1}	["ASPS-CPLX"]	"ASPARTYL-TRNA SYNTHETASE"
"ASPARTATE--TRNA-LIGASE-RXN_aspU-tRNA"	{"L-ASPARTATE": -1, "ATP": -1, "aspU-tRNA": -1, "PPI": 1, "AMP": 1, "charged-aspU-tRNA": 1}	["ASPS-CPLX"]	"ASPARTYL-TRNA SYNTHETASE"
"ASPARTATE--TRNA-LIGASE-RXN_aspV-tRNA"	{"L-ASPARTATE": -1, "ATP": -1, "aspV-tRNA": -1, "PPI": 1, "AMP": 1, "charged-aspV-tRNA": 1}	["ASPS-CPLX"]	"ASPARTYL-TRNA SYNTHETASE"
"CYSTEINE--TRNA-LIGASE-RXN_cysT-tRNA"	{"CYS": -1, "ATP": -1, "cysT-tRNA": -1, "PPI": 1, "AMP": 1, "charged-cysT-tRNA": 1}	["CYSS-MONOMER"]	"CYSTEINYL-TRNA SYNTHETASE"
"GLURS-RXN_gltT-tRNA"	{"GLT": -1, "ATP": -1, "gltT-tRNA": -1, "PPI": 1, "AMP": 1, "charged-gltT-tRNA": 1}	["GLURS-MONOMER"]	"GLUTAMYL-TRNA SYNTHETASE"
"GLURS-RXN_gltU-tRNA"	{"GLT": -1, "ATP": -1, "gltU-tRNA": -1, "PPI": 1, "AMP": 1, "charged-gltU-tRNA": 1}	["GLURS-MONOMER"]	"GLUTAMYL-TRNA SYNTHETASE"
"GLURS-RXN_gltV-tRNA"	{"GLT": -1, "ATP": -1, "gltV-tRNA": -1, "PPI": 1, "AMP": 1, "charged-gltV-tRNA": 1}	["GLURS-MONOMER"]	"GLUTAMYL-TRNA SYNTHETASE"
"GLURS-RXN_gltW-tRNA"	{"GLT": -1, "ATP": -1, "gltW-tRNA": -1, "PPI": 1, "AMP": 1, "charged-gltW-tRNA": 1}	["GLURS-MONOMER"]	"GLUTAMYL-TRNA SYNTHETASE"
"GLUTAMINE--TRNA-LIGASE-RXN_glnU-tRNA"	{"GLN": -1, "ATP": -1, "glnU-tRNA": -1, "PPI": 1, "AMP": 1, "charged-glnU-tRNA": 1}	["GLNS-MONOMER"]	"GLUTAMINYL-TRNA SYNTHETASE"
"GLUTAMINE--TRNA-LIGASE-RXN_glnV-tRNA"	{"GLN": -1, "ATP": -1, "glnV-tRNA": -1, "PPI": 1, "AMP": 1, "charged-glnV-tRNA": 1}	["GLNS-MONOMER"]	"GLUTAMINYL-TRNA SYNTHETASE"
"GLUTAMINE--TRNA-LIGASE-RXN_glnW-tRNA"	{"GLN": -1, "ATP": -1, "glnW-tRNA": -1, "PPI": 1, "AMP": 1, "charged-glnW-tRNA": 1}	["GLNS-MONOMER"]	"GLUTAMINYL-TRNA SYNTHETASE"
"GLUTAMINE--TRNA-LIGASE-RXN_glnX-tRNA"	{"GLN": -1, "ATP": -1, "glnX-tRNA": -1, "PPI": 1, "AMP": 1, "charged-glnX-tRNA": 1}	["GLNS-MONOMER"]	"GLUTAMINYL-TRNA SYNTHETASE"
"GLYCINE--TRNA-LIGASE-RXN_glyT-tRNA"	{"GLY": -1, "ATP": -1, "glyT-tRNA": -1, "PPI": 1, "AMP": 1, "charged-glyT-tRNA": 1}	["GLYS-CPLX"]	"GLYCYL-TRNA SYNTHETASE"
"GLYCINE--TRNA-LIGASE-RXN_glyU-tRNA"	{"GLY": -1, "ATP": -1, "glyU-tRNA": -1, "PPI": 1, "AMP": 1, "charged-glyU-tRNA": 1}	["GLYS-CPLX"]	"GLYCYL-TRNA SYNTHETASE"
"GLYCINE--TRNA-LIGASE-RXN_glyV-tRNA"	{"GLY": -1, "ATP": -1, "glyV-tRNA": -1, "PPI": 1, "AMP": 1, "charged-glyV-tRNA": 1}	["GLYS-CPLX"]	"GLYCYL-TRNA SYNTHETASE"
"GLYCINE--TRNA-LIGASE-RXN_glyW-tRNA"	{"GLY": -1, "ATP": -1, "glyW-tRNA": -1, "PPI": 1, "AMP": 1, "charged-glyW-tRNA": 1}	["GLYS-CPLX"]	"GLYCYL-TRNA SYNTHETASE"
"GLYCINE--TRNA-LIGASE-RXN_glyX-tRNA"	{"GLY": -1, "ATP": -1, "glyX-tRNA": -1, "PPI": 1, "AMP": 1, "charged-glyX-tRNA": 1}	["GLYS-CPLX"]	"GLYCYL-TRNA SYNTHETASE"
"GLYCINE--TRNA-LIGASE-RXN_glyY-tRNA"	{"GLY": -1, "ATP": -1, "glyY-tRNA": -1, "PPI": 1, "AMP": 1, "charged-glyY-tRNA": 1}	["GLYS-CPLX"]	"GLYCYL-TRNA SYNTHETASE"
"HISTIDINE--TRNA-LIGASE-RXN_hisR-tRNA"	{"HIS": -1, "ATP": -1, "hisR-tRNA": -1, "PPI": 1, "AMP": 1, "charged-hisR-tRNA": 1}	["HISS-CPLX"]	"HISTIDYL-TRNA SYNTHETASE"
"ISOLEUCINE--TRNA-LIGASE-RXN_ileT-tRNA"	{"ILE": -1, "ATP": -1, "ileT-tRNA": -1, "PPI": 1, "AMP": 1, "charged-ileT-tRNA": 1}	["ILES-MONOMER"]	"ISOLEUCYL-TRNA SYNTHETASE"
"ISOLEUCINE--TRNA-LIGASE-RXN_ileU-tRNA"	{"ILE": -1, "ATP": -1, "ileU-tRNA": -1, "PPI": 1, "AMP": 1, "charged-ileU-tRNA": 1}	["ILES-MONOMER"]	"ISOLEUCYL-TRNA SYNTHETASE"
"ISOLEUCINE--TRNA-LIGASE-RXN_ileV-tRNA"	{"ILE": -1, "ATP": -1, "ileV-tRNA": -1, "PPI": 1, "AMP": 1, "charged-ileV-tRNA": 1}	["ILES-MONOMER"]	"ISOLEUCYL-TRNA SYNTHETASE"
"ISOLEUCINE--TRNA-LIGASE-RXN_ileX-tRNA"	{"ILE": -1, "ATP": -1, "ileX-tRNA": -1, "PPI": 1, "AMP": 1, "charged-ileX-tRNA": 1}	["ILES-MONOMER"]	"ISOLEUCYL-TRNA SYNTHETASE"
"ISOLEUCINE--TRNA-LIGASE-RXN_RNA0-305"	{"ILE": -1, "ATP": -1, "RNA0-305": -1, "PPI": 1, "AMP": 1, "RNA0-309": 1}	["ILES-MONOMER"]	"ISOLEUCYL-TRNA SYNTHETASE"
"LEUCINE--TRNA-LIGASE-RXN_leuP-tRNA"	{"LEU": -1, "ATP": -1, "leuP-tRNA": -1, "PPI": 1, "AMP": 1, "charged-leuP-tRNA": 1}	["LEUS-MONOMER"]	"LEUCYL-TRNA SYNTHETASE"
"LEUCINE--TRNA-LIGASE-RXN_leuQ-tRNA"	{"LEU": -1, "ATP": -1, "leuQ-tRNA": -1, "PPI": 1, "AMP": 1, "charged-leuQ-tRNA": 1}	["LEUS-MONOMER"]	"LEUCYL-TRNA SYNTHETASE"
"LEUCINE--TRNA-LIGASE-RXN_leuT-tRNA"	{"LEU": -1, "ATP": -1, "leuT-tRNA": -1, "PPI": 1, "AMP": 1, "charged-leuT-tRNA": 1}	["LEUS-MONOMER"]	"LEUCYL-TRNA SYNTHETASE"
"LEUCINE--TRNA-LIGASE-RXN_leuU-tRNA"	{"LEU": -1, "ATP": -1, "leuU-tRNA": -1, "PPI": 1, "AMP": 1, "charged-leuU-tRNA": 1}	["LEUS-MONOMER"]	"LEUCYL-TRNA SYNTHETASE"
"LEUCINE--TRNA-LIGASE-RXN_leuV-tRNA"	{"LEU": -1, "ATP": -1, "leuV-tRNA": -1, "PPI": 1, "AMP": 1, "charged-leuV-tRNA": 1}	["LEUS-MONOMER"]	"LEUCYL-TRNA SYNTHETASE"
"LEUCINE--TRNA-LIGASE-RXN_leuW-tRNA"	{"LEU": -1, "ATP": -1, "leuW-tRNA": -1, "PPI": 1, "AMP": 1, "charged-leuW-tRNA": 1}	["LEUS-MONOMER"]	"LEUCYL-TRNA SYNTHETASE"
"LEUCINE--TRNA-LIGASE-RXN_leuX-tRNA"	{"LEU": -1, "ATP": -1, "leuX-tRNA": -1, "PPI": 1, "AMP": 1, "charged-leuX-tRNA": 1}	["LEUS-MONOMER"]	"LEUCYL-TRNA SYNTHETASE"
"LEUCINE--TRNA-LIGASE-RXN_leuZ-tRNA"	{"LEU": -1, "ATP": -1, "leuZ-tRNA": -1, "PPI": 1, "AMP": 1, "charged-leuZ-tRNA": 1}	["LEUS-MONOMER"]	"LEUCYL-TRNA SYNTHETASE"
"LYSINE--TRNA-LIGASE-RXN_lysT-tRNA"	{"LYS": -1, "ATP": -1, "lysT-tRNA": -1, "PPI": 1, "AMP": 1, "charged-lysT-tRNA": 1}	["LYSS-CPLX", "LYSU-CPLX"]	"LYSYL-TRNA SYNTHETASE"
"LYSINE--TRNA-LIGASE-RXN_lysV-tRNA"	{"LYS": -1, "ATP": -1, "lysV-tRNA": -1, "PPI": 1, "AMP": 1, "charged-lysV-tRNA": 1}	["LYSS-CPLX", "LYSU-CPLX"]	"LYSYL-TRNA SYNTHETASE"
"LYSINE--TRNA-LIGASE-RXN_lysW-tRNA"	{"LYS": -1, "ATP": -1, "lysW-tRNA": -1, "PPI": 1, "AMP": 1, "charged-lysW-tRNA": 1}	["LYSS-CPLX", "LYSU-CPLX"]	"LYSYL-TRNA SYNTHETASE"
"LYSINE--TRNA-LIGASE-RXN_RNA0-301"	{"LYS": -1, "ATP": -1, "RNA0-301": -1, "PPI": 1, "AMP": 1, "RNA0-312": 1}	["LYSS-CPLX", "LYSU-CPLX"]	"LYSYL-TRNA SYNTHETASE"
"LYSINE--TRNA-LIGASE-RXN_RNA0-302"	{"LYS": -1, "ATP": -1, "RNA0-302": -1, "PPI": 1, "AMP": 1, "RNA0-313": 1}	["LYSS-CPLX", "LYSU-CPLX"]	"LYSYL-TRNA SYNTHETASE"
"LYSINE--TRNA-LIGASE-RXN_RNA0-303"	{"LYS": -1, "ATP": -1, "RNA0-303": -1, "PPI": 1, "AMP": 1, "RNA0-314": 1}	["LYSS-CPLX", "LYSU-CPLX"]	"LYSYL-TRNA SYNTHETASE"
"METHIONINE--TRNA-LIGASE-RXN_metT-tRNA"	{"MET": -1, "ATP": -1, "metT-tRNA": -1, "PPI": 1, "AMP": 1, "charged-metT-tRNA": 1}	["METG-CPLX"]	"METHIONYL-TRNA SYNTHETASE"
"METHIONINE--TRNA-LIGASE-RXN_metU-tRNA"	{"MET": -1, "ATP": -1, "metU-tRNA": -1, "PPI": 1, "AMP": 1, "charged-metU-tRNA": 1}	["METG-CPLX"]	"METHIONYL-TRNA SYNTHETASE"
"PHENYLALANINE--TRNA-LIGASE-RXN_pheU-tRNA"	{"PHE": -1, "ATP": -1, "pheU-tRNA": -1, "PPI": 1, "AMP": 1, "charged-pheU-tRNA": 1}	["PHES-CPLX"]	"PHENYLALANYL-TRNA SYNTHETASE"
"PHENYLALANINE--TRNA-LIGASE-RXN_pheV-tRNA"	{"PHE": -1, "ATP": -1, "pheV-tRNA": -1, "PPI": 1, "AMP": 1, "charged-pheV-tRNA": 1}	["PHES-CPLX"]	"PHENYLALANYL-TRNA SYNTHETASE"
"PROLINE--TRNA-LIGASE-RXN_proK-tRNA"	{"PRO": -1, "ATP": -1, "proK-tRNA": -1, "PPI": 1, "AMP": 1, "charged-proK-tRNA": 1}	["PROS-CPLX"]	"PROLYL-TRNA SYNTHETASE"
"PROLINE--TRNA-LIGASE-RXN_proL-tRNA"	{"PRO": -1, "ATP": -1, "proL-tRNA": -1, "PPI": 1, "AMP": 1, "charged-proL-tRNA": 1}	["PROS-CPLX"]	"PROLYL-TRNA SYNTHETASE"
"PROLINE--TRNA-LIGASE-RXN_proM-tRNA"	{"PRO": -1, "ATP": -1, "proM-tRNA": -1, "PPI": 1, "AMP": 1, "charged-proM-tRNA": 1}	["PROS-CPLX"]	"PROLYL-TRNA SYNTHETASE"
"RXN-16165_metW-tRNA"	{"MET": -1, "ATP": -1, "metW-tRNA": -1, "PPI": 1, "AMP": 1, "RNA0-319": 1}	["METG-CPLX"]	null
"RXN-16165_metY-tRNA"	{"MET": -1, "ATP": -1, "metY-tRNA": -1, "PPI": 1, "AMP": 1, "RNA0-322": 1}	["METG-CPLX"]	null
"RXN-16165_metZ-tRNA"	{"MET": -1, "ATP": -1, "metZ-tRNA": -1, "PPI": 1, "AMP": 1, "RNA0-323": 1}	["METG-CPLX"]	null
"RXN-16165_RNA0-306"	{"MET": -1, "ATP": -1, "RNA0-306": -1, "PPI": 1, "AMP": 1, "RNA0-321": 1}	["METG-CPLX"]	null
"RXN0-2161_selC-tRNA"	{"SER": -1, "ATP": -1, "selC-tRNA": -1, "PPI": 1, "AMP": 1, "charged-selC-tRNA": 1}	["SERS-CPLX"]	null
"SERINE--TRNA-LIGASE-RXN_serT-tRNA"	{"SER": -1, "ATP": -1, "serT-tRNA": -1, "PPI": 1, "AMP": 1, "charged-serT-tRNA": 1}	["SERS-CPLX"]	"SERYL-TRNA SYNTHETASE"
"SERINE--TRNA-LIGASE-RXN_serU-tRNA"	{"SER": -1, "ATP": -1, "serU-tRNA": -1, "PPI": 1, "AMP": 1, "charged-serU-tRNA": 1}	["SERS-CPLX"]	"SERYL-TRNA SYNTHETASE"
"SERINE--TRNA-LIGASE-RXN_serV-tRNA"	{"SER": -1, "ATP": -1, "serV-tRNA": -1, "PPI": 1, "AMP": 1, "charged-serV-tRNA": 1}	["SERS-CPLX"]	"SERYL-TRNA SYNTHETASE"
"SERINE--TRNA-LIGASE-RXN_serW-tRNA"	{"SER": -1, "ATP": -1, "serW-tRNA": -1, "PPI": 1, "AMP": 1, "charged-serW-tRNA": 1}	["SERS-CPLX"]	"SERYL-TRNA SYNTHETASE"
"SERINE--TRNA-LIGASE-RXN_serX-tRNA"	{"SER": -1, "ATP": -1, "serX-tRNA": -1, "PPI": 1, "AMP": 1, "charged-serX-tRNA": 1}	["SERS-CPLX"]	"SERYL-TRNA SYNTHETASE"
"THREONINE--TRNA-LIGASE-RXN_thrT-tRNA"	{"THR": -1, "ATP": -1, "thrT-tRNA": -1, "PPI": 1, "AMP": 1, "charged-thrT-tRNA": 1}	["THRS-CPLX"]	"THREONYL-TRNA SYNTHETASE"
"THREONINE--TRNA-LIGASE-RXN_thrU-tRNA"	{"THR": -1, "ATP": -1, "thrU-tRNA": -1, "PPI": 1, "AMP": 1, "charged-thrU-tRNA": 1}	["THRS-CPLX"]	"THREONYL-TRNA SYNTHETASE"
"THREONINE--TRNA-LIGASE-RXN_thrV-tRNA"	{"THR": -1, "ATP": -1, "thrV-tRNA": -1, "PPI": 1, "AMP": 1, "charged-thrV-tRNA": 1}	["THRS-CPLX"]	"THREONYL-TRNA SYNTHETASE"
"THREONINE--TRNA-LIGASE-RXN_thrW-tRNA"	{"THR": -1, "ATP": -1, "thrW-tRNA": -1, "PPI": 1, "AMP": 1, "charged-thrW-tRNA": 1}	["THRS-CPLX"]	"THREONYL-TRNA SYNTHETASE"
"TRYPTOPHAN--TRNA-LIGASE-RXN_trpT-tRNA"	{"TRP": -1, "ATP": -1, "trpT-tRNA": -1, "PPI": 1, "AMP": 1, "charged-trpT-tRNA": 1}	["TRPS-CPLX"]	"TRYPTOPHANYL-TRNA SYNTHETASE"
"TYROSINE--TRNA-LIGASE-RXN_tyrT-tRNA"	{"TYR": -1, "ATP": -1, "tyrT-tRNA": -1, "PPI": 1, "AMP": 1, "charged-tyrT-tRNA": 1}	["TYRS-CPLX"]	"TYROSYL-TRNA SYNTHETASE"
"TYROSINE--TRNA-LIGASE-RXN_tyrU-tRNA"	{"TYR": -1, "ATP": -1, "tyrU-tRNA": -1, "PPI": 1, "AMP": 1, "charged-tyrU-tRNA": 1}	["TYRS-CPLX"]	"TYROSYL-TRNA SYNTHETASE"
"TYROSINE--TRNA-LIGASE-RXN_tyrV-tRNA"	{"TYR": -1, "ATP": -1, "tyrV-tRNA": -1, "PPI": 1, "AMP": 1, "charged-tyrV-tRNA": 1}	["TYRS-CPLX"]	"TYROSYL-TRNA SYNTHETASE"
"VALINE--TRNA-LIGASE-RXN_RNA0-300"	{"VAL": -1, "ATP": -1, "RNA0-300": -1, "PPI": 1, "AMP": 1, "RNA0-311": 1}	["VALS-MONOMER"]	"VALYL-TRNA SYNTHETASE"
"VALINE--TRNA-LIGASE-RXN_valT-tRNA"	{"VAL": -1, "ATP": -1, "valT-tRNA": -1, "PPI": 1, "AMP": 1, "charged-valT-tRNA": 1}	["VALS-MONOMER"]	"VALYL-TRNA SYNTHETASE"
"VALINE--TRNA-LIGASE-RXN_valU-tRNA"	{"VAL": -1, "ATP": -1, "valU-tRNA": -1, "PPI": 1, "AMP": 1, "charged-valU-tRNA": 1}	["VALS-MONOMER"]	"VALYL-TRNA SYNTHETASE"
"VALINE--TRNA-LIGASE-RXN_valV-tRNA"	{"VAL": -1, "ATP": -1, "valV-tRNA": -1, "PPI": 1, "AMP": 1, "charged-valV-tRNA": 1}	["VALS-MONOMER"]	"VALYL-TRNA SYNTHETASE"
"VALINE--TRNA-LIGASE-RXN_valW-tRNA"	{"VAL": -1, "ATP": -1, "valW-tRNA": -1, "PPI": 1, "AMP": 1, "charged-valW-tRNA": 1}	["VALS-MONOMER"]	"VALYL-TRNA SYNTHETASE"
"VALINE--TRNA-LIGASE-RXN_valX-tRNA"	{"VAL": -1, "ATP": -1, "valX-tRNA": -1, "PPI": 1, "AMP": 1, "charged-valX-tRNA": 1}	["VALS-MONOMER"]	"VALYL-TRNA SYNTHETASE"
"VALINE--TRNA-LIGASE-RXN_valY-tRNA"	{"VAL": -1, "ATP": -1, "valY-tRNA": -1, "PPI": 1, "AMP": 1, "charged-valY-tRNA": 1}	["VALS-MONOMER"]	"VALYL-TRNA SYNTHETASE"
