"Object ID"	"Display Name"	"Synonyms"
"G6912-MONOMER"	"MenI"	"[MenI, YdiI]"
"NAPHTHOATE-SYN-MONOMER"	"MenB"	"[MenB]"
"DXPREDISOM-MONOMER"	"YaeM"	"[YaeM, IspC, Dxr]"
"DXS-MONOMER"	"YajP"	"[YajP, Dxs]"
"EG11081-MONOMER"	"YaaE"	"[YaaE, LytB, IspH]"
"1-PFK-MONOMER"	"Fpk"	"[Fpk, FruF, FruK]"
"G7641-MONOMER"	"RsmI"	"[RsmI, YraL, ribosomal RNA small subunit methyltransferase I]"
"EG12366-MONOMER"	"YggJ"	"[YggJ, RsmE]"
"EG11085-MONOMER"	"RsmH"	"[RsmH, YabC, MraW]"
"GPMA-MONOMER"	"Gpm"	"[Gpm, GpmA]"
"G7490-MONOMER"	"YgeX"	"[YgeX]"
"ENTA-MONOMER"	"EntA"	"[EntA]"
"ENTE-MONOMER"	"EntE"	"[EntE]"
"EG12279-MONOMER"	"YiaK"	"[YiaK]"
"TRANS-CPLX-203"	"YiaMNO binding protein-dependent secondary (TRAP) transporter"	"[YiaMNO binding protein-dependent secondary (TRAP) transporter]"
"AKBLIG-MONOMER"	"Kbl"	"[Kbl]"
"EG11870-MONOMER"	"YiiM"	"[YiiM, protein involved in base analog detoxification]"
"EG11816-MONOMER"	"YgbB"	"[YgbB, IspF]"
"G7423-MONOMER"	"YgbP"	"[YgbP, IspD, 4-diphosphocytidyl-2C-methyl-D-erythritol synthase]"
"MHPCHYDROL-MONOMER"	"MhpC"	"[MhpC]"
"G6721-MONOMER"	"YdbZ"	"[YdbZ, PaaY]"
"MHPDHYDROL-MONOMER"	"MhpS"	"[MhpS, MhpD]"
"G7158-MONOMER"	"YfaU"	"[YfaU]"
"G6198-MONOMER"	"YahS"	"[YahS, YzzD, PrpC]"
"G6196-MONOMER"	"YahQ"	"[YahQ, PrpB]"
"2OXOGLUTARATEDEH-CPLX"	"OGDH"	"[OGDH]"
"MEND-MONOMER"	"MenD"	"[MenD]"
"G7845-MONOMER"	"RlmB"	"[RlmB, YjfH]"
"EG11254-MONOMER"	"YbeA"	"[YbeA, RlmH]"
"G6501-MONOMER"	"YccW"	"[YccW, RlmI]"
"DIOHBUTANONEPSYN-MONOMER"	"LuxH"	"[LuxH, HtrP, RibB]"
"DHPDIOXYGEN-MONOMER"	"MhpB"	"[MhpB, 2,3-dihydroxyphenylpropionate/2,3-dihydroxycinnamate 1,2-dioxygenase]"
"AROD-MONOMER"	"AroD"	"[AroD]"
"AROG-MONOMER"	"AroG"	"[AroG, 2-dehydro-3-deoxyphosphoheptonate aldolase]"
"AROH-MONOMER"	"2-dehydro-3-deoxyphosphoheptonate aldolase"	"[2-dehydro-3-deoxyphosphoheptonate aldolase, AroH]"
"AROF-MONOMER"	"AroF"	"[AroF, 2-dehydro-3-deoxyphosphoheptonate aldolase]"
"G7663-MONOMER"	"YrbJ"	"[YrbJ, KdsC, YrbI]"
"KDO-8PSYNTH-MONOMER"	"KdsA"	"[KdsA]"
"EG12345-MONOMER"	"YdfG"	"[YdfG]"
"G6804-MONOMER"	"LsrF"	"[LsrF, YneB]"
"FABZ-MONOMER"	"YaeA"	"[YaeA, SefA, FabZ]"
"3-ISOPROPYLMALISOM-CPLX"	"isopropylmalate isomerase"	"[isopropylmalate isomerase, &alpha;-isopropylmalate isomerase, &alpha;-IPM isomerase, IPMI, 3-isopropylmalate isomerase, 3-carboxy-3-hydroxy-isocaproate isomerase]"
"3-ISOPROPYLMALDEHYDROG-MONOMER"	"LeuB"	"[LeuB]"
"G7858-MONOMER"	"YjfV"	"[YjfV, SgaH, UlaD]"
"FADA-MONOMER"	"OldA"	"[OldA, FadA]"
"3-CH3-2-OXOBUTANOATE-OH-CH3-XFER-MONOMER"	"PanB"	"[PanB]"
"EG11396-MONOMER"	"YigY"	"[YigY, YigC, UbiD]"
"3-OXOACYL-ACP-REDUCT-MONOMER"	"FabG"	"[FabG, 3-oxoacyl-[acyl-carrier-protein] reductase subunit]"
"EG11847-MONOMER"	"SquU"	"[SquU, YihU]"
"EG11294-MONOMER"	"Ipk"	"[Ipk, YchB, IspE]"
"PABASYN-CPLX"	""	"[]"
"GABATRANSAM-MONOMER"	"GabT"	"[GabT]"
"DIHYDROPICRED-MONOMER"	"DapB"	"[DapB, DHPR, dihydrodipicolinate reductase]"
"DIHYDRODIPICSYN-MONOMER"	"DapA"	"[DapA, DHDPS, dihydrodipicolinate synthase]"
"PDXA-MONOMER"	"PdxA"	"[PdxA]"
"EG11090-MONOMER"	"Mtn"	"[Mtn, YadA, Pfs]"
"METHYLENETHFREDUCT-MONOMER"	"MetF"	"[MetF]"
"PURK-MONOMER"	"PurK"	"[PurK, purE2 peptide, CO2 subunit, AIR carboxylase]"
"EG10997-MONOMER"	"MnmE"	"[MnmE, TrmE, ThdF, GTPase, involved in modification of U34 in tRNA, 5-carboxymethylaminomethyluridine-tRNA synthase subunit MnmE]"
"EG10375-MONOMER"	"GidA"	"[GidA, MnmG, protein involved in modification of U34 in tRNA, TrmF]"
"CPLX0-7609"	""	"[]"
"G7463-MONOMER"	"YqeE"	"[YqeE, KduI, 5-keto 4-deoxyuronate isomerase]"
"CPLX0-8249"	""	"[]"
"EG10725-MONOMER"	"PhnP"	"[PhnP]"
"CPLX0-3956"	""	"[]"
"EG10873-MONOMER"	"RplL"	"[RplL, 50S ribosomal subunit protein L7/L12]"
"LUMAZINESYN-MONOMER"	"YbaF"	"[YbaF, RibH, RibE]"
"G7431-MONOMER"	"SscR"	"[SscR, YgcM, QueD]"
"6PFK-1-MONOMER"	"PfkA"	"[PfkA]"
"6PFK-2-MONOMER"	"PfkB"	"[PfkB]"
"6PGLUCONDEHYDROG-MONOMER"	"Gnd"	"[Gnd]"
"7-ALPHA-HYDROXYSTEROID-DEH-MONOMER"	"HdhA"	"[HdhA, Hsd, HsdH]"
"G7452-MONOMER"	"YqcD"	"[YqcD, QueF]"
"7KAPSYN-MONOMER"	"BioF"	"[BioF]"
"YJCG-MONOMER"	"YjcG"	"[YjcG, ActP]"
"ACETOACETYL-COA-TRANSFER-CPLX"	""	"[]"
"ACETOLACTSYNII-CPLX"	"AHAS"	"[AHAS, AHAS II, acetohydroxy acid synthase II, acetohydroxybutanoate synthase II, acetolactate synthase II]"
"ACETOLACTSYNI-CPLX"	"acetohydroxybutanoate synthase I"	"[acetohydroxybutanoate synthase I, acetohydroxy-acid synthase I, acetolactate synthase I, AHASI]"
"ACETOLACTSYNIII-CPLX"	"acetolactate synthase III"	"[acetolactate synthase III, acetohydroxy acid synthase III, AHAS III, acetohydroxybutanoate synthase III]"
"ACETYL-COA-ACETYLTRANSFER-MONOMER"	"AtoB"	"[AtoB]"
"ACETYL-COA-CARBOXYLMULTI-CPLX"	""	"[]"
"ACETYL-COA-CARBOXYLTRANSFER-CPLX"	""	"[]"
"ATOD-MONOMER"	"AtoD"	"[AtoD]"
"ATOA-MONOMER"	"AtoA"	"[AtoA]"
"G7234-MONOMER"	"YfdE"	"[YfdE]"
"EG11101-MONOMER"	"YbaC"	"[YbaC, Aes]"
"ACETYLGLUTKIN-MONOMER"	"ArgB"	"[ArgB]"
"ACETYLORNDEACET-MONOMER"	"ArgE"	"[ArgE]"
"APHA-MONOMER"	"HobH"	"[HobH, YjbP, AphA]"
"ACONITASE-MONOMER"	"Acn"	"[Acn, AcnA]"
"EG11315-MONOMER"	"AcuI"	"[AcuI, YhdH]"
"THIOESTERII-MONOMER"	"TesB"	"[TesB]"
"EG11692-MONOMER"	"AdeD"	"[AdeD, Adu, Ade, YicP, cryptic adenine deaminase]"
"ADENPRIBOSYLTRAN-MONOMER"	"Apt"	"[Apt]"
"DAPASYN-MONOMER"	"BioA"	"[BioA]"
"ASL-MONOMER"	"Ade"	"[Ade, PurB]"
"ADENYLOSUCCINATE-SYN-MONOMER"	"AdeK"	"[AdeK, PurA]"
"ADENYLYLSULFKIN-MONOMER"	"CysC"	"[CysC]"
"EG10838-MONOMER"	"HldD"	"[HldD, WaaD, NbsB, HtrM, RfaD]"
"G7740-MONOMER"	"NudE"	"[NudE, YrfE, ADP-sugar pyrophosphorylase]"
"EG12633-MONOMER"	"AspP"	"[AspP, NudF, YqiE, TrgB]"
"FAO-CPLX"	""	"[]"
"AERGLYC3PDEHYDROG-MONOMER"	"GlyD"	"[GlyD, GlpD]"
"AGMATIN-MONOMER"	"SpeB"	"[SpeB]"
"ALARACEBIOSYN-MONOMER"	"Alr"	"[Alr, alanine racemase 1, PLP-binding, biosynthetic, biosynthetic alanine racemase]"
"ALARACECAT-MONOMER"	"DadB"	"[DadB, AlnB, AlnA, DadX, alanine racemase 2, PLP-binding]"
"ALAS-MONOMER"	"Act"	"[Act, LovB, AlaS, ala-act]"
"CPLX0-7805"	"YagTSR"	"[YagTSR, PaoABC]"
"LACTALDDEHYDROG-MONOMER"	"Ald"	"[Ald, AldA]"
"ALDDEHYDROGB-MONOMER"	"YiaX"	"[YiaX, AldB]"
"ADHE-MONOMER"	"AdhC"	"[AdhC, Ana, AdhE]"
"ABC-56-CPLX"	"YcbE/YcbM ABC transporter"	"[YcbE/YcbM ABC transporter, alkanesulfonate ABC transporter]"
"ALKAPHOSPHA-MONOMER"	"PsiA"	"[PsiA, PhoA]"
"CPLX0-245"	""	"[]"
"OPPSYN-MONOMER"	"Cel"	"[Cel, YhbD, IspB]"
"G6285-MONOMER"	"YlbB"	"[YlbB, AllC]"
"G6281-MONOMER"	"YbbX"	"[YbbX, AllB]"
"RIB5PISOMB-MONOMER"	"YjcA"	"[YjcA, AlsI, RpiB]"
"EG11685-MONOMER"	"YicI"	"[YicI]"
"KDGALDOL-MONOMER"	"YhaF"	"[YhaF, GarL]"
"ALPHAGALACTOSID-MONOMER"	"MelA"	"[MelA]"
"PRPPAMIDOTRANS-MONOMER"	"Ade"	"[Ade, PurC, PurF]"
"EG11157-MONOMER"	"YgeA"	"[YgeA]"
"ADCLY-MONOMER"	"PabC"	"[PabC]"
"EG10694-MONOMER"	"PepA"	"[PepA, XerB, CarP]"
"EG12310-MONOMER"	"YfhI"	"[YfhI, PepB]"
"AMTB-MONOMER"	"YbaG"	"[YbaG, AmtB ammonium Amt transporter, AmtB]"
"AMP-NUCLEOSID-MONOMER"	"Amn"	"[Amn]"
"CPLX0-1668"	""	"[]"
"ANGLYC3PDEHYDROG-CPLX"	"G3P dehydrogenase"	"[G3P dehydrogenase, sn-glycerol-3-phosphate:(acceptor) 2-oxidoreductase, glycerol-3-phosphate:menaquinone oxidoreductase]"
"G7413-MONOMER"	"YgaK"	"[YgaK, YgaI, YgaJ, NorV, FlRd, flavorubredoxin]"
"NRDACTMULTI-CPLX"	""	"[]"
"RIBONUCLEOSIDE-TRIP-REDUCT-MONOMER"	"NrdD"	"[NrdD]"
"RNTRACTIV-MONOMER"	"YjgE"	"[YjgE, NrdG]"
"ANTHRANSYN-CPLX"	""	"[]"
"G7348-MONOMER"	"RseB"	"[RseB]"
"EG10571-MONOMER"	"MazE"	"[MazE, ChpR, ChpAI]"
"G7601-MONOMER"	"YgjM"	"[YgjM, HigA, HigA antitoxin of the HigB-HigA toxin-antitoxin system]"
"EG10442-MONOMER"	"HipB"	"[HipB]"
"ABC-2-CPLX"	""	"[]"
"ARGDECARBOXBIO-MONOMER"	"SpeA"	"[SpeA]"
"ARGDECARBOXDEG-MONOMER"	"AdiA"	"[AdiA, Adi]"
"YJDE-MONOMER"	"YjdD"	"[YjdD, YjdE, AdiC]"
"ARGSUCCINSYN-MONOMER"	"ArgG"	"[ArgG]"
"CPLX0-4"	"AaeAB"	"[AaeAB]"
"ARSF-MONOMER"	"ArsF"	"[ArsF, ArsB]"
"G6770-MONOMER"	"NhoA"	"[NhoA, YddI]"
"ASNSYNA-MONOMER"	"AsnA"	"[AsnA]"
"ASNSYNB-MONOMER"	"AsnB"	"[AsnB]"
"ASNS-MONOMER"	"Tss"	"[Tss, Lcs, AsnS, AsnRS]"
"CPLX0-2901"	""	"[]"
"ASPAMINOTRANS-MONOMER"	"AspC"	"[AspC]"
"ASPARTASE-MONOMER"	"AspA"	"[AspA]"
"ASPCARBTRANS-CPLX"	""	"[]"
"ASPCARBCAT-MONOMER"	"PyrB"	"[PyrB]"
"ASPCARBREG-MONOMER"	"PyrI"	"[PyrI]"
"ASPKINIII-MONOMER"	"Apk"	"[Apk, LysC]"
"ASPS-MONOMER"	"Tls"	"[Tls, AspS, AspRS]"
"ASP-SEMIALDEHYDE-DEHYDROGENASE-MONOMER"	"Dap"	"[Dap, Hom, Asd]"
"SULFITE-REDUCT-CPLX"	""	"[]"
"CPLX0-3957"	""	"[]"
"ATPPHOSRIBOSTRANS-MONOMER"	"HisG"	"[HisG]"
"ATPSYN-CPLX"	"ATP synthase FoF1"	"[ATP synthase FoF1, ATP synthase F1Fo]"
"F-1-CPLX"	""	"[]"
"ATPA-MONOMER"	"UncA"	"[UncA, PapA, AtpA]"
"ATPD-MONOMER"	"UncD"	"[UncD, PapB, AtpD, ATP synthase F<sub>1</sub> complex - beta subunit]"
"F-O-CPLX"	""	"[]"
"ATPF-MONOMER"	"UncF"	"[UncF, PapF, AtpF, B chain, ATP synthase F<sub>o</sub> complex - b subunit]"
"ATPE-MONOMER"	"UncE"	"[UncE, PapH, AtpE, dicyclohexylcarbodiimide-binding protein, ATP synthase F<sub>0</sub> complex - subunit c]"
"EG10613-MONOMER"	"MsbA"	"[MsbA]"
"EG10156-MONOMER"	"LopD"	"[LopD, ATP-binding component of serine protease, ClpA]"
"EG10159-MONOMER"	"LopC"	"[LopC, ClpX]"
"EG10158-MONOMER"	"LopP"	"[LopP, heat shock protein F21.5, ClpP]"
"EG10837-MONOMER"	"MmrA"	"[MmrA, MbrA, DasC, Rep, Rep helicase, a single-stranded DNA-dependent ATPase]"
"G6939-MONOMER"	"Spy"	"[Spy]"
"EG11881-MONOMER"	"HtpI"	"[HtpI, ClpY, HslU, D48.5]"
"ABC-58-CPLX"	"LsrACDB"	"[LsrACDB]"
"CPLX0-2561"	""	"[]"
"EG10113-MONOMER"	"Bfr"	"[Bfr, cytochrome b1]"
"EG10242-MONOMER"	"DnaN"	"[DnaN, DNA polymerase III subunit &beta;]"
"BETAGALACTOSID-MONOMER"	"LacZ"	"[LacZ]"
"BGLF-MONOMER"	"BglS"	"[BglS, BglF]"
"ASCF-MONOMER"	"Sac"	"[Sac, AscF]"
"BETA-GLUCURONID-MONOMER"	"GusA"	"[GusA, GurA, UidA]"
"FABA-MONOMER"	"FabA"	"[FabA, &beta;-hydroxyacyl-ACP dehydratase/isomerase]"
"FABB-MONOMER"	"FabC"	"[FabC, FabB, &beta;-ketoacyl-ACP synthase I]"
"3-OXOACYL-ACP-SYNTHII-MONOMER"	"Vtr"	"[Vtr, Cvc, VtrB, FabJ, FabF, &beta;-ketoacyl-ACP synthase II]"
"FABH-MONOMER"	"FabH"	"[FabH, &beta;-ketoacyl-ACP synthase III]"
"BADH-MONOMER"	"BetB"	"[BetB]"
"DHHB-METHYLTRANSFER-MONOMER"	"PufX"	"[PufX, YfaB, UbiG]"
"FOLD-MONOMER"	"Ads"	"[Ads, FolD]"
"ACONITATEDEHYDRB-MONOMER"	"YacI"	"[YacI, YacJ, AcnB]"
"HMP-P-KIN-MONOMER"	"ThiJ"	"[ThiJ, ThiA, ThiN, ThiD]"
"BCCP-CPLX"	"BCCP"	"[BCCP, AccB]"
"BIOTIN-CARBOXYL-MONOMER"	"AccC"	"[AccC, FabG]"
"BIOTIN-SYN-MONOMER"	"BioB"	"[BioB]"
"ABC-15-CPLX"	"LIV-I transport system"	"[LIV-I transport system]"
"BRANCHED-CHAINAMINOTRANSFER-MONOMER"	"IlvE"	"[IlvE]"
"G7880-MONOMER"	"BdcA"	"[BdcA, YjgI]"
"CARBPSYN-CPLX"	""	"[]"
"EG11447-MONOMER"	"ZfiA"	"[ZfiA, CsrA, pleiotropic regulatory protein for carbon source metabolism, translational dual regulator CsrA]"
"CPLX0-7935"	"C-P lyase core complex"	"[C-P lyase core complex]"
"CARBODEHYDRAT-MONOMER"	"CynT"	"[CynT]"
"EG12319-MONOMER"	"YadF"	"[YadF, Can]"
"G7020-MONOMER"	"CmoA"	"[CmoA, YecO]"
"G6326-MONOMER"	"YbdK"	"[YbdK]"
"G7853-MONOMER"	"YjfP"	"[YjfP]"
"CPLX0-8232"	""	"[]"
"G6988-MONOMER"	"YeaW"	"[YeaW, 2Fe-2S cluster-containing protein]"
"CPLX0-8174"	""	"[]"
"THREDEHYDCAT-MONOMER"	"Tdc"	"[Tdc, TdcB]"
"HYDROPEROXIDII-MONOMER"	"KatE"	"[KatE]"
"EG11878-MONOMER"	"YiiU"	"[YiiU, ZapB]"
"EG12313-MONOMER"	"ZapD"	"[ZapD, YacF]"
"EG12878-MONOMER"	"ZapA"	"[ZapA, YgfE, cell division factor ZapA, localizes to the cytokinetic ring]"
"CPLX0-8125"	""	"[]"
"EG10240-MONOMER"	"GrpC"	"[GrpC, GroP, DnaJ, DnaK co-chaperone Hsp40]"
"EG10461-MONOMER"	"HtpG"	"[HtpG, C62.5, Hsp90, molecular chaperone, HSP90 family]"
"PROTEIN-CHEA"	"CheA"	"[CheA]"
"CHEZ-MONOMER"	"CheZ"	"[CheZ]"
"TAR-CPLX"	"MCP-II signaling complex"	"[MCP-II signaling complex]"
"TAP-CPLX"	"MCP-IV chemotaxis signaling complex"	"[MCP-IV chemotaxis signaling complex]"
"TRG-CPLX"	"MCP-III signaling complex"	"[MCP-III signaling complex]"
"TSR-CPLX"	"MCP-I signaling complex"	"[MCP-I signaling complex]"
"YADQ-MONOMER"	"EriC"	"[EriC, ClcA, YadQ, ClC-ec1]"
"AROC-MONOMER"	"AroC"	"[AroC]"
"CPLX0-7561"	""	"[]"
"EG11723-MONOMER"	"ChrR"	"[ChrR, YieF]"
"EG10618-MONOMER"	"MukB"	"[MukB, cell division protein involved in chromosome partitioning]"
"EG12165-MONOMER"	"KicB"	"[KicB, MukF, Ca<sup>2+</sup>-binding protein involved in chromosome partitioning]"
"ACPSUB-MONOMER"	"YbdX"	"[YbdX, CitD, citrate lyase, acyl carrier &gamma; subunit]"
"CITTRANS-MONOMER"	"YbdV"	"[YbdV, CitF, citrate lyase, citrate-ACP transferase &alpha; subunit, citrate lyase, citrate-acyl carrier protein transferase &alpha; subunit, citrate lyase citrate-acyl carrier protein transferase subunit]"
"CITRYLY-MONOMER"	"YbdW"	"[YbdW, CitE, citrate lyase, citryl-ACP lyase &beta; subunit, citrate lyase citryl-acyl carrier protein lyase subunit]"
"CITLY-CPLX"	"(HS)-citrate lyase"	"[(HS)-citrate lyase, citrate lyase, thiol form, deacetyl-citrate lyase]"
"CITSYN-MONOMER"	"IcdB"	"[IcdB, GltA]"
"CPLX0-3104"	""	"[]"
"CPLX0-3108"	"ATP-dependent endopeptidase Clp"	"[ATP-dependent endopeptidase Clp, ATP-dependent protease Clp]"
"EG10157-MONOMER"	"HtpM"	"[HtpM, ClpB, F84.1, F68.5, E89]"
"CPLX0-3107"	""	"[]"
"EG10978-MONOMER"	"SspB"	"[SspB]"
"COBU-MONOMER"	"CobU"	"[CobU]"
"CPLX0-2221"	""	"[]"
"EG12177-MONOMER"	"CutA"	"[CutA]"
"AMINEOXID-MONOMER"	"MaoA"	"[MaoA, FeaA, TynA]"
"CPLX0-1721"	"CusCFBA"	"[CusCFBA]"
"COPROGENOXI-MONOMER"	"Sec"	"[Sec, PopB, HemF]"
"G7365-MONOMER"	"YfjN"	"[YfjN, RnlA, Std]"
"G6140-MONOMER"	"YagE"	"[YagE]"
"CPLX0-7725"	"Cascade"	"[Cascade]"
"EG12845-MONOMER"	"YgbF"	"[YgbF, Cas2]"
"ABC-23-CPLX"	"PhnCDE"	"[PhnCDE]"
"CTPSYN-MONOMER"	"PyrG"	"[PyrG]"
"CPLX-3945"	""	"[]"
"EG12193-MONOMER"	"CbpA"	"[CbpA, chaperone with DnaK; curved DNA-binding protein]"
"CYANLY-MONOMER"	"Cnt"	"[Cnt, CyaN, CynS]"
"G7314-MONOMER"	"PdeF"	"[PdeF, YfgF]"
"EG11666-MONOMER"	"MoaC"	"[MoaC]"
"CFA-MONOMER"	"Cfa"	"[Cfa, CdfA]"
"CYSTATHIONINE-BETA-LYASE-MONOMER"	"MetC"	"[MetC]"
"G7325-MONOMER"	"NuvC"	"[NuvC, YzzO, YfhO, IscS]"
"G7454-MONOMER"	"YgdJ"	"[YgdJ, CsdA]"
"ACSERLYB-MONOMER"	"CysM"	"[CysM]"
"CYSSYNMULTI-CPLX"	""	"[]"
"CPLX0-8152"	""	"[]"
"CYTIDEAM-MONOMER"	"Cdd"	"[Cdd]"
"CYT-D-UBIOX-CPLX"	"ubiquinol oxidase (electrogenic, non H<sup>+</sup> transporting)"	"[ubiquinol oxidase (electrogenic, non H<sup>+</sup> transporting), cytochrome <i>d</i> complex, cytochrome <i>bd</i> complex, cytochrome <i>d</i> ubiquinol oxidase complex, cytochrome <i>b558-d</i> complex, ubiquinol:oxygen oxidoreductase]"
"APP-UBIOX-CPLX"	"CbdAB"	"[CbdAB, AppCB]"
"CYT-O-UBIOX-CPLX"	"ubiquinol oxidase (H<sup>+</sup>-transporting)"	"[ubiquinol oxidase (H<sup>+</sup>-transporting), cytochrome <i>bo</i> ubiquinol oxidase, cytochrome <i>o</i> ubiquinol oxidase, ubiquinol:oxygen oxidoreductase, cytochrome b562-o complex, cytochrome <i>bo<sub>3</sub></i>, cytochrome <i>bo</i><sub>3</sub> terminal oxidase]"
"CYTDEAM-MONOMER"	"CodA"	"[CodA]"
"DALADALALIGB-MONOMER"	"Ddl"	"[Ddl, DdlB]"
"EG10201-MONOMER"	"Pfv"	"[Pfv, DacA, PBP5, penicillin-binding protein 5, murein D,D-carboxypeptidase DacA, D-alanine carboxypeptidase IA]"
"EG10203-MONOMER"	"DacC"	"[DacC, penicillin-binding protein 6, PBP6, murein DD-carboxypeptidase, PBP6a]"
"ABC-42-CPLX"	""	"[]"
"DALADEHYDROGA-MONOMER"	"DadR"	"[DadR, DadA]"
"EG11852-MONOMER"	"Dtd"	"[Dtd, YihZ, D-Tyr-tRNA<sup>Tyr</sup> deacylase]"
"EG10973-MONOMER"	"SrlQ"	"[SrlQ, GutQ]"
"G7662-MONOMER"	"KdsD"	"[KdsD, YrbH]"
"DCYSDESULF-MONOMER"	"YedO"	"[YedO, DcyD]"
"ERYTH4PDEHYDROG-MONOMER"	"GapB"	"[GapB, Gap2, Epd]"
"ABC-18-CPLX"	"MglBAC"	"[MglBAC, MglP]"
"GLUCONOKINII-MONOMER"	"GntK"	"[GntK]"
"DLACTDEHYDROGNAD-MONOMER"	"HtpH"	"[HtpH, HslI, HslF, LdhA, D-lactate dehydrogenase - fermentative]"
"EG10817-MONOMER"	"RbsP"	"[RbsP, RbsD]"
"G6106-MONOMER"	"YafI"	"[YafI, TfrA, GmhA, LpcA]"
"G7185-MONOMER"	"YfbR"	"[YfbR]"
"DCTP-DEAM-MONOMER"	"Dus"	"[Dus, PaxA, Dcd]"
"PHOSPHO-DCUR-MONOMER"	"YjdG"	"[YjdG, DcuR]"
"CPLX0-2381"	""	"[]"
"DUTP-PYROP-MONOMER"	"Sof"	"[Sof, DnaS, Dut]"
"EG11835-MONOMER"	"YihI"	"[YihI, GAP-like protein that activates GTPase activity of Der]"
"DETHIOBIOTIN-SYN-MONOMER"	"BioD"	"[BioD]"
"DGTPTRIPHYDRO-MONOMER"	"Dgt"	"[Dgt, OptA]"
"DIACYLGLYKIN-MONOMER"	"DgkA"	"[DgkA]"
"DIAMINOPIMDECARB-MONOMER"	"LysA"	"[LysA]"
"DIAMINOPIMEPIM-MONOMER"	"DapF"	"[DapF]"
"G6673-MONOMER"	"DgcM"	"[DgcM, YdaM]"
"EG11643-MONOMER"	"DgcZ"	"[DgcZ, YdeG, YdeH]"
"G6784-MONOMER"	"DgcO"	"[DgcO, YddV, DosC]"
"E2O-MONOMER"	"E2(o) subunit"	"[E2(o) subunit, SucB]"
"H2NEOPTERINALDOL-MONOMER"	"YgiG"	"[YgiG, FolB]"
"H2NTPEPIM-MONOMER"	"FolX"	"[FolX]"
"DIHYDROOROT-MONOMER"	"PyrC"	"[PyrC]"
"H2PTEROATESYNTH-MONOMER"	"DhpS"	"[DhpS, FolP]"
"DIHYDROXYACIDDEHYDRAT-MONOMER"	"IlvD"	"[IlvD]"
"CPLX0-2081"	"DHAK"	"[DHAK, DHA kinase]"
"EG12399-MONOMER"	"DhaM"	"[DhaM, DhaH, YcgC, PtsD]"
"DIMESULFREDUCT-CPLX"	"DMSO/TMAO reductase"	"[DMSO/TMAO reductase, menaquinol:dimethyl sulfoxide oxidoreductase]"
"CPLX0-7787"	"DinJ/Q"	"[DinJ/Q]"
"ABC-8-CPLX"	"DppABCDF"	"[DppABCDF]"
"G7194-MONOMER"	"YfcG"	"[YfcG, GST N1-1]"
"G7553-MONOMER"	"YghU"	"[YghU, GST N2-2]"
"G7530-MONOMER"	"YggV"	"[YggV, RdgB]"
"ABC-54-CPLX"	""	"[]"
"G6306-MONOMER"	"YbcP"	"[YbcP, RusA, Rus, DLP12 prophage; endodeoxyribonuclease RUS (Holliday junction resolvase)]"
"G6303-MONOMER"	"YbcN"	"[YbcN]"
"CPLX0-2425"	"Topoisomerase II"	"[Topoisomerase II]"
"EG10245-MONOMER"	"DnaZ"	"[DnaZ, DnaX, DNA elongation factor III]"
"CPLX0-2361"	""	"[]"
"CPLX0-3803"	""	"[]"
"CPLX0-3801"	""	"[]"
"CPLX0-7910"	""	"[]"
"CPLX0-3925"	"Pol V"	"[Pol V]"
"EG11111-MONOMER"	"YbjA"	"[YbjA, CspH, CspD]"
"CPLX0-2424"	"Topo IV"	"[Topo IV]"
"EG10686-MONOMER"	"ParC"	"[ParC, DNA topoisomerase 4 subunit A]"
"EG10466-MONOMER"	"HupA"	"[HupA, transcriptional dual regulator HU-&alpha; (HU-2)]"
"G6088-MONOMER"	"CaiF"	"[CaiF]"
"PD00221"	"RhaS"	"[RhaS]"
"EG11236-MONOMER"	"PdeL"	"[PdeL, YahA]"
"PD00242"	"AraC"	"[AraC]"
"EG10490-MONOMER"	"ArgP"	"[ArgP, IciA]"
"PD00194"	"XerA"	"[XerA, ArgR]"
"PD00250"	"AsnC"	"[AsnC]"
"PD00521"	"Shl"	"[Shl, FruC, FruR, Cra]"
"PD00257"	"GurB"	"[GurB, Csm, Cap, Crp]"
"CPLX0-7708"	""	"[]"
"PD00232"	"positive transcriptional regulator for cysteine regulon"	"[positive transcriptional regulator for cysteine regulon, CysB]"
"PD00297"	"DsdC"	"[DsdC]"
"PD00196"	"Nbp"	"[Nbp, site-specific DNA inversion stimulation factor, Fis]"
"PD00197"	"OssA"	"[OssA, NirR, NirA, OxrA, Fnr]"
"CPLX0-2021"	"HU"	"[HU, HU&alpha;&beta;]"
"G7924-MONOMER"	"HypT"	"[HypT, QseD, YjiE]"
"PC00027"	"IHF"	"[IHF]"
"PD03938"	"MetR"	"[MetR]"
"MONOMER0-185"	"ModR"	"[ModR, ChlD, ModE-MoO<sub>4</sub><sup>2-</sup>, ModE]"
"G7262-MONOMER"	"YfeT"	"[YfeT, MurR]"
"PROTEIN-NRI"	"GlnT"	"[GlnT, GlnG, NtrC, NtrC response regulator]"
"EG12344-MONOMER"	"YcjB"	"[YcjB, PspF]"
"TORR-MONOMER"	"TorR response regulator"	"[TorR response regulator, TorR]"
"EG12235-MONOMER"	"ArsE"	"[ArsE, ArsR]"
"PD04028"	"CytR"	"[CytR]"
"G6209-MONOMER"	"YaiN"	"[YaiN, FrmR]"
"PD00205"	"Tsl"	"[Tsl, Spr, UmuA, ExrA, LexA]"
"G6799-MONOMER"	"YdeW"	"[YdeW, LsrR]"
"PD00364"	"SoxQ"	"[SoxQ, InaR, CfxB, MarR]"
"PD01103"	"YbgB"	"[YbgB, FarR, MngR]"
"EG10603-MONOMER"	"MprA"	"[MprA, EmrR]"
"EG11212-MONOMER"	"YjeB"	"[YjeB, NsrR]"
"G6720-MONOMER"	"YdbY"	"[YdbY, PaaX]"
"PD00219"	"PurR"	"[PurR]"
"EG12202-MONOMER"	"TreR"	"[TreR]"
"PD00423"	"RtrY"	"[RtrY, TrpR]"
"EG11929-MONOMER"	"ZnuR"	"[ZnuR, YjbK, Zur]"
"PD04413"	"NadI"	"[NadI, NadR]"
"YRAO-MONOMER"	"YraO"	"[YraO, DiaA]"
"FADB-MONOMER"	"OldB"	"[OldB, FadB]"
"CPLX0-7823"	""	"[]"
"DSBG-MONOMER"	"YbdP"	"[YbdP, DsbG]"
"RFFTRANS-MONOMER"	"Rff"	"[Rff, YifI, RffA, FcnA, WecE]"
"DTDPGLUCDEHYDRAT-MONOMER"	"RmlB"	"[RmlB, Som, RfbB]"
"DTDPGLUCOSEPP-MONOMER"	"Som"	"[Som, RfbA, RmlA]"
"DTDPGLUCOSEPP2-MONOMER"	"YifG"	"[YifG, RffH]"
"DTDPRHAMSYNTHMULTI-CPLX"	""	"[]"
"EG11126-MONOMER"	"YciF"	"[YciF]"
"CPLX0-3958"	""	"[]"
"EG11211-MONOMER"	"EpmA"	"[EpmA, YjeA, GenX, PoxA]"
"G7877-MONOMER"	"RidA"	"[RidA, YjgF]"
"EG11249-MONOMER"	"MazF"	"[MazF, ChpA, ChpAK, MazF toxin of the MazF-MazE toxin-antitoxin system that exhibits ribonuclease activity]"
"CPLX0-1923"	""	"[]"
"ENOLASE-MONOMER"	"Eno"	"[Eno]"
"ENOYL-ACP-REDUCT-NADH-MONOMER"	"Gts"	"[Gts, QmeA, EnvM, FabI]"
"CPLX0-3976"	""	"[]"
"ENTMULTI-CPLX"	"enterobactin synthetase multienzyme complex"	"[enterobactin synthetase multienzyme complex]"
"ERYTHRON4PDEHYDROG-MONOMER"	"PdxB"	"[PdxB]"
"ADHP-MONOMER"	"YddN"	"[YddN, AdhP]"
"ETHAMLY-CPLX"	""	"[]"
"CPLX0-3937"	""	"[]"
"UVRABC-CPLX"	"excinuclease ABC"	"[excinuclease ABC, UvrABC excinuclease, excinuclease UvrABC, excision nuclease ABC, UvrABC system excision endonuclease, ABC excision nuclease]"
"RECBCD"	"Exonuclease V"	"[Exonuclease V, RecBCD]"
"CPLX-3946"	"ExoVII"	"[ExoVII]"
"PPX-MONOMER"	"Ppx"	"[Ppx]"
"ACYLCOASYN-MONOMER"	"OldD"	"[OldD, FadD]"
"CPLX-3944"	""	"[]"
"ABC-9-CPLX"	"iron dicitrate ABC transporter"	"[iron dicitrate ABC transporter, ferric dicitrate ABC transporter]"
"CPLX0-1943"	"ferric dicitrate outer membrane transport complex"	"[ferric dicitrate outer membrane transport complex]"
"CPLX0-7952"	""	"[]"
"ABC-10-CPLX"	""	"[]"
"CPLX0-1941"	""	"[]"
"CPLX0-1942"	""	"[]"
"EG10921-MONOMER"	"RsgA"	"[RsgA, FtnA, Ftn]"
"CPLX0-8227"	""	"[]"
"CPLX0-3401"	"type 1 pilin complex"	"[type 1 pilin complex]"
"G7865-MONOMER"	"YtfC"	"[YtfC, FklB, FKBP22]"
"EG11663-MONOMER"	"SlyD"	"[SlyD, WHP]"
"CPLX0-7451"	""	"[]"
"FLAGELLAR-MOTOR-COMPLEX"	""	"[]"
"CPLX0-7450"	""	"[]"
"CPLX0-7452"	""	"[]"
"CPLX0-3930"	"FlhDC"	"[FlhDC]"
"G6731-MONOMER"	"AzoR"	"[AzoR, AcpD, FMN dependent azoreductase]"
"MONOMER-162"	"YcbN"	"[YcbN, SsuD]"
"FOCA-MONOMER"	"YcaE"	"[YcaE, FocA]"
"EG10284-MONOMER"	"FdhE"	"[FdhE]"
"FORMATEDEHYDROGN-CPLX"	"Fdh-N"	"[Fdh-N, formate:menaquinone oxidoreductase]"
"ALPHA-SUBUNIT-CPLX"	""	"[]"
"FORMATEDEHYDROGO-CPLX"	"FDH-O"	"[FDH-O, FDH-Z, formate:quinone oxidoreductase O, formate:quinone oxidoreductase Z]"
"FHLMULTI-CPLX"	"FHL"	"[FHL]"
"G7237-MONOMER"	"YfdW"	"[YfdW, Frc]"
"FORMYLTHFDEFORMYL-MONOMER"	"YchI"	"[YchI, Tgs, PurU]"
"G7005-MONOMER"	"MsrC"	"[MsrC, YebR, fRMsr]"
"EG11245-MONOMER"	"YggK"	"[YggK, YggF]"
"F16B-MONOMER"	"Fdp"	"[Fdp, Fbp, fructose-1,6-bisphosphatase I]"
"EG11517-MONOMER"	"GlpX"	"[GlpX, fructose 1,6-bisphosphatase II]"
"G6428-MONOMER"	"YbiZ"	"[YbiZ, FsaA, MipB, Fsa]"
"FRUCBISALD-CLASSI-MONOMER"	"DhnA"	"[DhnA, FbaB]"
"FRUCTBISALD-CLASSII-MONOMER"	"Fda"	"[Fda, Ald, FbaA, Fba]"
"CPLX-158"	"EII<sup>Fru</sup>"	"[EII<sup>Fru</sup>, Enzyme II<sup>Fru</sup>, fructose PTS permease]"
"G7724-MONOMER"	"YhfP"	"[YhfP, YhfO, FrlC]"
"G7723-MONOMER"	"YhfN"	"[YhfN, FrlB]"
"CPLX0-2982"	"FtsH holoenzyme"	"[FtsH holoenzyme]"
"CPLX0-7934"	""	"[]"
"FUMA-MONOMER"	"FumA"	"[FumA]"
"FUMB-MONOMER"	"FumB"	"[FumB]"
"FUMC-MONOMER"	"FumC"	"[FumC]"
"FUMARATE-REDUCTASE"	"menaquinol:fumarate oxidoreductase"	"[menaquinol:fumarate oxidoreductase, FRD, QFR, fumarate reductase, quinol:fumarate oxidoreductase]"
"CPLX0-7639"	""	"[]"
"EG10004-MONOMER"	"Dfp"	"[Dfp, CoaBC]"
"ASPKINIHOMOSERDEHYDROGI-MONOMER"	"ThrD"	"[ThrD, ThrA]"
"ASPKINIIHOMOSERDEHYDROGII-MONOMER"	"MetM"	"[MetM, MetL]"
"CHORISMUTPREPHENDEHYDRAT-MONOMER"	"PheA"	"[PheA]"
"CHORISMUTPREPHENDEHYDROG-MONOMER"	"TyrA"	"[TyrA]"
"RIBOFLAVINSYNDEAM-MONOMER"	"YbaE"	"[YbaE, RibG, RibD]"
"PUTA-MONOMER"	"PutC"	"[PutC, PoaA, PutA, proline utilization A]"
"GSP-MONOMER"	"Gsp"	"[Gsp, Gss]"
"G7590-MONOMER"	"HldE"	"[HldE, YqiF, RfaE, GmhC, WaaE]"
"NAG1P-URIDYLTRANS-MONOMER"	"YieA"	"[YieA, GlmU]"
"G7168-MONOMER"	"ArnA"	"[ArnA, YfbG, PmrI]"
"CPLX0-7852"	"GadRcs"	"[GadRcs]"
"GALACTITOLPDEHYD-MONOMER"	"GatD"	"[GatD]"
"CPLX0-231"	"EII<sup>Gat</sup>"	"[EII<sup>Gat</sup>, Enzyme II <sup>Gat</sup>]"
"ABC-46-CPLX"	""	"[]"
"CPLX-170"	"EII<sup>Gam</sup>"	"[EII<sup>Gam</sup>, Enzyme II<sup>Gam</sup>, EII<suP>GalN</sup>, Enzyme II<suP>GalN</sup>]"
"GALACTURIDYLYLTRANS-MONOMER"	"GalB"	"[GalB, GalT]"
"GALACTOACETYLTRAN-MONOMER"	"LacA"	"[LacA, thiogalactoside acetyltransferase]"
"G6755-MONOMER"	"PatD"	"[PatD, YdcW, Prr]"
"CARNDEHYDRA-MONOMER"	"YaaN"	"[YaaN, CaiB]"
"G6645-MONOMER"	"YcjL"	"[YcjL, PuuD]"
"FCL-MONOMER"	"YefB"	"[YefB, WcaG, Fcl]"
"GDPMANDEHYDRA-MONOMER"	"YefN"	"[YefN, YefA, Gmd]"
"EG12410-MONOMER"	"YffH"	"[YffH, NudK, GDPMK]"
"GDPMANMANHYDRO-MONOMER"	"Gmm"	"[Gmm, NudD, YefC, WcaH]"
"GLUCOSAMINE-6-P-DEAMIN-MONOMER"	"GlmD"	"[GlmD, NagB]"
"GLUCOSE-1-PHOSPHAT-MONOMER"	"Agp"	"[Agp]"
"GLUC1PADENYLTRANS-MONOMER"	"GlgC"	"[GlgC]"
"PGLUCISOM"	"Pgi"	"[Pgi]"
"CPLX-157"	"EII<sup>glc</sup>"	"[EII<sup>glc</sup>, enzyme II <sup>glc</sup>]"
"ABC-13-CPLX"	""	"[]"
"GLUTKIN-MONOMER"	"ProB"	"[ProB]"
"GLUTDECARBOXA-MONOMER"	"GadS"	"[GadS, GadA]"
"GLUTDECARBOXB-MONOMER"	"GadB"	"[GadB]"
"GDHA-MONOMER"	"GdhA"	"[GdhA]"
"GLUTAMATESYN-CPLX"	"NADPH-GOGAT"	"[NADPH-GOGAT]"
"GLUTAMATESYN-DIMER"	""	"[]"
"G7184-MONOMER"	"YfbQ"	"[YfbQ, AlaA]"
"G7242-MONOMER"	"YfdZ"	"[YfdZ, AlaC]"
"GSAAMINOTRANS-MONOMER"	"Gsa"	"[Gsa, PopC, HemL]"
"GLUTSEMIALDEHYDROG-MONOMER"	"ProA"	"[ProA]"
"G6644-MONOMER"	"YcjK"	"[YcjK, PuuA]"
"G6261-MONOMER"	"GlsA"	"[GlsA, YbaS]"
"G6810-MONOMER"	"GlsB"	"[GlsB, YneH]"
"GLUTAMINESYN-MONOMER"	"GlnA"	"[GlnA]"
"GLUTRNAREDUCT-MONOMER"	"GtrA"	"[GtrA, HemA]"
"EG12181-MONOMER"	"YdhD"	"[YdhD, GrxD, Grx4]"
"ABC-6-CPLX"	""	"[]"
"ABC-49-CPLX"	""	"[]"
"CPLX0-7885"	"&gamma;-glutamyl transpeptidase"	"[&gamma;-glutamyl transpeptidase]"
"GLUTATHIONE-REDUCT-NADPH-MONOMER"	"GorA"	"[GorA, Gor]"
"GST-MONOMER"	"Gst"	"[Gst, GstA]"
"GLUTATHIONE-SYN-MONOMER"	"GshB"	"[GshB]"
"G7616-MONOMER"	"YqjG"	"[YqjG, S-glutathionyl-(chloro)hydroquinone reductase]"
"GAPDH-A-MONOMER"	"Gad"	"[Gad, GapA, Gap1]"
"GLPF-MONOMER"	"GlpF"	"[GlpF]"
"GLYCEROL-KIN-MONOMER"	"GlpK"	"[GlpK]"
"GLYC3PDEHYDROGBIOSYN-MONOMER"	"GpsA"	"[GpsA]"
"GLYCPDIESTER-PERI-MONOMER"	"GlpQ"	"[GlpQ, glycerophosphoryl diester phosphodiesterase, periplasmic]"
"ABC-26-CPLX"	"PPIII"	"[PPIII, proline permease III, ProVWX]"
"ABC-40-CPLX"	""	"[]"
"GCVMULTI-CPLX"	""	"[]"
"GCVP-MONOMER"	"GcvP"	"[GcvP, P-protein]"
"GLYS-CPLX"	"GlyRS"	"[GlyRS]"
"GLYCOPHOSPHORYL-MONOMER"	"GlgY"	"[GlgY, GlgP]"
"CPLX0-7458"	""	"[]"
"GLYOXI-MONOMER"	"GloA"	"[GloA]"
"GLYOCARBOLIG-MONOMER"	"Gcl"	"[Gcl]"
"MONOMER-43"	"TkrA"	"[TkrA, YiaE, GhrB]"
"GMP-REDUCT-MONOMER"	"GuaC"	"[GuaC]"
"GMP-SYN-MONOMER"	"GuaA"	"[GuaA]"
"CPLX0-3934"	"GroE"	"[GroE]"
"CPLX0-7942"	""	"[]"
"CPLX0-8239"	""	"[]"
"GTP-CYCLOHYDRO-I-MONOMER"	"FolE"	"[FolE, GTP cyclohydrolase I]"
"GTP-CYCLOHYDRO-II-MONOMER"	"RibA"	"[RibA, GTP cyclohydrolase II]"
"PPPGPPHYDRO-MONOMER"	"GppA"	"[GppA, Gpp]"
"GUANYL-KIN-MONOMER"	"SpoR"	"[SpoR, Gmk]"
"EG11398-MONOMER"	"YhhC"	"[YhhC, YhiB, HdeA]"
"G6500-MONOMER"	"YccV"	"[YccV, HspQ]"
"ABC-35-CPLX"	"CcmABCDE protoheme IX ABC transporter"	"[CcmABCDE protoheme IX ABC transporter]"
"EG11735-MONOMER"	"YcdB"	"[YcdB, EfeB]"
"CPLX0-1321"	"HflA"	"[HflA]"
"CPLX0-8230"	"HigBA"	"[HigBA]"
"CPLX0-7425"	"HipBA"	"[HipBA]"
"HISTDEHYD-MONOMER"	"HisD"	"[HisD]"
"ABC-14-CPLX"	""	"[]"
"HISS-MONOMER"	"HisS"	"[HisS, HisRS]"
"HISTPHOSTRANS-MONOMER"	"HisC"	"[HisC]"
"HOLO-ENTB"	""	"[]"
"HOLO-ACP-SYNTH-MONOMER"	"AcpS"	"[AcpS, Dpj, AcpSholo]"
"CPLX0-3323"	"cytochrome <i>c</i> heme lyase"	"[cytochrome <i>c</i> heme lyase]"
"HOMOSERKIN-MONOMER"	"ThrB"	"[ThrB]"
"HOMSUCTRAN-MONOMER"	"MetA"	"[MetA]"
"CPLX0-1163"	"ClpYQ protease"	"[ClpYQ protease, HslUV protease]"
"FORMHYDROGI-CPLX"	"HYD1"	"[HYD1, hydrogenase I, NiFe hydrogenase, hydrogen:menaquinone oxidoreductase, hydrogen oxidase, hydrogen:oxygen oxidoreductase]"
"CPLX0-8167"	""	"[]"
"FORMHYDROG2-CPLX"	"HYD2"	"[HYD2, hydrogenase-2, hydrogen:menaquinone oxidoreductase 2]"
"HYDROG3-CPLX"	""	"[]"
"CPLX0-250"	"Hyf"	"[Hyf, HYD4]"
"EG10484-MONOMER"	"HydB"	"[HydB, HypB, accessory protein for nickel incorporation into hydrogenase isoenzymes]"
"HYDROPEROXIDI-MONOMER"	"KatG"	"[KatG]"
"THZ-KIN-MONOMER"	"ThiM"	"[ThiM]"
"G7058-MONOMER"	"HiuH"	"[HiuH, YedX]"
"G6277-MONOMER"	"YbbG"	"[YbbG, Hyi, glyoxylate-induced protein, Gip]"
"CPLX0-3821"	""	"[]"
"CPLX0-7986"	""	"[]"
"HYPOXANPRIBOSYLTRAN-MONOMER"	"Hpt"	"[Hpt]"
"GLUTAMIDOTRANS-CPLX"	""	"[]"
"IMIDPHOSPHADEHYDHISTIDPHOSPHA-MONOMER"	"HisB"	"[HisB]"
"IMP-DEHYDROG-MONOMER"	"GuaR"	"[GuaR, GuaB]"
"INORGPYROPHOSPHAT-MONOMER"	"Ppa"	"[Ppa]"
"GSK-MONOMER"	"Gsk"	"[Gsk]"
"ABC-45-CPLX"	""	"[]"
"G6491-MONOMER"	"PqiB"	"[PqiB]"
"ABC-11-CPLX"	""	"[]"
"G7748-MONOMER"	"YhgI"	"[YhgI, GntY, NfuA, iron-sulfur cluster insertion protein NfuA]"
"EG12332-MONOMER"	"YadR"	"[YadR, ErpA, essential respiratory protein A]"
"EG12132-MONOMER"	"IscA"	"[IscA, YfhF, iron-sulfur cluster assembly protein]"
"EG11378-MONOMER"	"YdiC"	"[YdiC, SufA, Fe-S transport protein in Fe-S cluster assembly]"
"G6212-MONOMER"	"InsC-1"	"[InsC-1]"
"G7925-MONOMER"	"YjiF"	"[YjiF, IadA]"
"CPLX0-263"	"asparaginase 3"	"[asparaginase 3]"
"MENF-MONOMER"	"YfbA"	"[YfbA, MenF, isochorismate synthase 2]"
"ISOCITDEH-SUBUNIT"	"IcdE"	"[IcdE, IcdA, Icd]"
"ICITDEHASE-KIN-PHOSPHA"	"AceK"	"[AceK]"
"ISOCIT-LYASE-MONOMER"	"Icl"	"[Icl, AceA]"
"EG12600-MONOMER"	"YjjX"	"[YjjX]"
"KEFC-MONOMER"	"TrkC"	"[TrkC, KefC]"
"KCH-MONOMER"	"Kch"	"[Kch]"
"ATPASE-1-CPLX"	"Kdp-ATPase"	"[Kdp-ATPase]"
"PHOSPHO-KDPE"	""	"[]"
"KETOLREDUCTOISOM-MONOMER"	"IlvC"	"[IlvC]"
"KDPGALDOL-4OH2OXOGLUTARALDOL-MONOMER"	"Kga"	"[Kga, Hga, KdgA, Eda]"
"LTARTDEHYDRA-CPLX"	"L-Ttd"	"[L-Ttd]"
"GLYCDEH-MONOMER"	"GldA"	"[GldA]"
"LACTALDREDUCT-MONOMER"	"FucO"	"[FucO]"
"G6759-MONOMER"	"MnaT"	"[MnaT, YncA]"
"ARABISOM-MONOMER"	"AraA"	"[AraA]"
"ABC-4-CPLX"	""	"[]"
"EIISGA"	"EII<sup>Sga</sup>"	"[EII<sup>Sga</sup>, EII<sup>Ula</sup>, Enzyme II<sup>Sga</sup>, Enzyme II<sup>Ula</sup>]"
"G7855-MONOMER"	"YjfR"	"[YjfR, UlaG]"
"ANSA-MONOMER"	"AnsA"	"[AnsA, asparaginase I]"
"ANSB-MONOMER"	"AnsB"	"[AnsB, asparaginase II]"
"CAIT-MONOMER"	"YaaP"	"[YaaP, CaiT]"
"G6906-MONOMER"	"CsdB"	"[CsdB, YnhB, SufS]"
"FUCISOM-MONOMER"	"FucI"	"[FucI]"
"EG10355-MONOMER"	"FucU"	"[FucU]"
"FUCPALDOL-MONOMER"	"Prd"	"[Prd, FucC, FucA]"
"ABC-12-CPLX"	""	"[]"
"L-GLN-FRUCT-6-P-AMINOTRANS-MONOMER"	"GlmS"	"[GlmS]"
"METNIQ-METHIONINE-ABC-CPLX"	""	"[]"
"G7160-MONOMER"	"RhmD"	"[RhmD, YfaW]"
"RHAMNISOM-MONOMER"	"RhaA"	"[RhaA]"
"EG11865-MONOMER"	"YiiL"	"[YiiL, RhaM]"
"RIBULPEPIM-MONOMER"	"AraD"	"[AraD]"
"LSERINEDEAM3-MONOMER"	"YhaQ"	"[YhaQ, YhaP, SdhY, TdcG, L-serine dehydratase 3]"
"CPLX0-7684"	"YgaZ/YgaH L-valine exporter complex"	"[YgaZ/YgaH L-valine exporter complex]"
"LYXK-MONOMER"	"XylK"	"[XylK, Lyx, YiaP, SgbK, LyxK]"
"EG11180-MONOMER"	"YhdC"	"[YhdC, MscL]"
"ABC-304-CPLX"	""	"[]"
"LIPIDADISACCHARIDESYNTH-MONOMER"	"PgsB"	"[PgsB, LpxB]"
"G6660-MONOMER"	"YzzJ"	"[YzzJ, Tpx, p20, scavengase, scavengase p20, thiol peroxidase]"
"EG12180-MONOMER"	"YbeG"	"[YbeG, CrcA, PagP]"
"E3-MONOMER"	"Lpd"	"[Lpd, Dhl, LpdA, E3 subunit]"
"CPLX0-7992"	""	"[]"
"CPLX0-7628"	""	"[]"
"EG12371-MONOMER"	"YhbM"	"[YhbM, NlpI]"
"ABC-62-CPLX"	""	"[]"
"EG11306-MONOMER"	"Lip"	"[Lip, LipA]"
"EG10542-MONOMER"	"Muc"	"[Muc, Dir, Deg, LopA, CapR, Lon, DNA-binding, ATP-dependent protease La]"
"LTAA-MONOMER"	"LtaA"	"[LtaA, YbjU, LtaE]"
"ABC-3-CPLX"	""	"[]"
"LYSDECARBOX-MONOMER"	"LdcI"	"[LdcI, CadA]"
"LDC2-MONOMER"	"LdcC"	"[LdcC, Ldc, LdcH, lysine decarboxylase, constitutive]"
"LYSS-MONOMER"	"HerC"	"[HerC, AsuD, LysS, LysRSs]"
"LYSU-MONOMER"	"LysU"	"[LysU]"
"EG12855-MONOMER"	"YcbG"	"[YcbG, MatP]"
"TRANS-200-CPLX"	"YbjYZ"	"[YbjYZ]"
"MALIC-NADP-MONOMER"	"YpfF"	"[YpfF, MaeB]"
"MALATE-DEHASE-MONOMER"	"Mdh"	"[Mdh]"
"MALIC-NAD-MONOMER"	"MaeA"	"[MaeA, SfcA]"
"MALDEXPHOSPHORYL-MONOMER"	"MalA"	"[MalA, Blu, MalP]"
"ABC-16-CPLX"	""	"[]"
"MALTACETYLTRAN-MONOMER"	"Maa"	"[Maa, YlaD]"
"EG10528-MONOMER"	"MalL"	"[MalL, MalB, LamB]"
"CPLX-156"	"EII<sup>Cmt</sup>"	"[EII<sup>Cmt</sup>, Enzyme II<sup>Cmt</sup>]"
"MTLA-MONOMER"	"MtlC"	"[MtlC, MtlA]"
"CPLX-165"	"EII<sup>man</sup>"	"[EII<sup>man</sup>, Enzyme II <sup>mannose</sup>]"
"MANX-MONOMER"	"ManX"	"[ManX, Mpt, PtsX, PtsM, PtsL, GptB, IIIMan, Enzyme III<sup>man</sup>, Enzyme IIAB<sup>man</sup>]"
"CPLX0-1242"	"MazE-MazF addiction module"	"[MazE-MazF addiction module, MazFE, MazEF]"
"CPLX0-2661"	""	"[]"
"TMAOREDUCTI-CPLX"	"TorCA"	"[TorCA]"
"S-ADENMETSYN-MONOMER"	"MetX"	"[MetX, MetK]"
"METG-MONOMER"	"MetG"	"[MetG, MetRS]"
"TAP-MONOMER"	"Tap"	"[Tap, Tap dimer, MCP-IV, dipeptide chemoreceptor protein, chemotaxis signaling protein IV]"
"TAR-MONOMER"	"CheM"	"[CheM, MCP-II, aspartate chemoreceptor protein, Tar dimer, chemotaxis signaling protein II]"
"TRG-MONOMER"	"MCP-III"	"[MCP-III, ribose/galactose/glucose chemoreceptor protein, Trg, Trg dimer, chemotaxis signaling protein III]"
"TSR-MONOMER"	"CheD"	"[CheD, Tsr, serine chemoreceptor protein, Tsr dimer, MCP-I, chemotaxis signaling protein I]"
"METHGLYSYN-MONOMER"	"Mgs"	"[Mgs, YccG, MgsA]"
"G7516-MONOMER"	"ScpB"	"[ScpB, YgfG]"
"METHYLMALONYL-COA-MUT-MONOMER"	"YliK"	"[YliK, Sbm, ScpA]"
"CPLX0-7958"	""	"[]"
"CPLX0-7796"	""	"[]"
"G7840-MONOMER"	"YjeP"	"[YjeP, MscM]"
"G6323-MONOMER"	"YbdG"	"[YbdG]"
"CPLX0-8255"	""	"[]"
"CPLX0-7672"	""	"[]"
"MONOMER0-1501"	"MoaB"	"[MoaB]"
"G6417-MONOMER"	"YbiO"	"[YbiO]"
"ABC-19-CPLX"	""	"[]"
"G6154-MONOMER"	"PaoD"	"[PaoD, YagQ]"
"EG11511-MONOMER"	"YaaG"	"[YaaG, MogA, ChlG, BisD, Mog]"
"EG10153-MONOMER"	"NarE"	"[NarE, ChlE, BisB, MoeA]"
"CPLX0-2502"	"MPT synthase"	"[MPT synthase]"
"EG11828-MONOMER"	"YihC"	"[YihC, MobB]"
"EG10154-MONOMER"	"ChlN"	"[ChlN, MoeB]"
"EG10144-MONOMER"	"YdjD"	"[YdjD, ChbF, CelF]"
"CPLX0-7822"	"MqsAR"	"[MqsAR]"
"MONOMER0-2461"	""	"[]"
"CPLX0-7697"	""	"[]"
"ABC-57-CPLX"	""	"[]"
"TRANS-CPLX-201"	""	"[]"
"CPLX0-3932"	""	"[]"
"CPLX0-2141"	""	"[]"
"CPLX0-2121"	""	"[]"
"CPLX0-2161"	""	"[]"
"TRANS-CPLX-202"	""	"[]"
"TRANS-CPLX-204"	""	"[]"
"EMRE-MONOMER"	"MvrC"	"[MvrC, EmrE, EB<sup>R</sup>]"
"YDGEF-CPLX"	"MdtJI spermidine SMR transporter"	"[MdtJI spermidine SMR transporter]"
"THIOESTERI-MONOMER"	"PldC"	"[PldC, ApeA, TesA, long chain fatty acyl thioesterase I, lysophospholipase L<SUB>1</SUB>, lecithinase B, phospholipase B, thioesterase I, acyl-CoA thioesterase I]"
"G7425-MONOMER"	"YgbT"	"[YgbT, Cas1]"
"CPLX0-3970"	""	"[]"
"G6662-MONOMER"	"YcjI"	"[YcjI, MpaA]"
"MUTHLS-CPLX"	""	"[]"
"CPLX-155"	"EII<sup>cel</sup>"	"[EII<sup>cel</sup>, EII<sup>chb</sup>, Enzyme II<sup>cel</sup>, Enzyme II <sup>chb</sup>]"
"CPLX0-7610"	""	"[]"
"NAGE-MONOMER"	"PtsN"	"[PtsN, PstN, NagE]"
"NAG6PDEACET-MONOMER"	"NagA"	"[NagA]"
"N-ACETYLTRANSFER-MONOMER"	"ArgA"	"[ArgA]"
"G7263-MONOMER"	"YfeU"	"[YfeU, MurQ]"
"CPLX0-7"	"Enzyme II<sup>NAcMur</sup>"	"[Enzyme II<sup>NAcMur</sup>, EII<sup>NAcMur</sup>]"
"ACNEULY-MONOMER"	"Npl"	"[Npl, NanA]"
"G7920-MONOMER"	"YjhT"	"[YjhT, NanM]"
"ACETYLORNTRANSAM-MONOMER"	"Dtu"	"[Dtu, DapC, ArgD]"
"SUCCARGDIHYDRO-MONOMER"	"YdjT"	"[YdjT, AstB]"
"PURE-MONOMER"	"Ade"	"[Ade, purE1 peptide, AIR carboxylase subunit, catalytic subunit, AIR carboxylase, PurE]"
"CPLX0-8182"	""	"[]"
"CPLX0-8181"	""	"[]"
"NHAA-MONOMER"	"Hyc"	"[Hyc, Ant, AntA, NhaA]"
"MONOMER0-541"	"YfjE"	"[YfjE, NadK, YfjB]"
"NAD-SYNTH-MONOMER"	"Efg"	"[Efg, NtrL, NadE]"
"DIHYDROPTERIREDUCT-MONOMER"	"Ntr"	"[Ntr, NfsB, DprA, NfnB]"
"PD01343"	"WrbA"	"[WrbA]"
"G6811-MONOMER"	"YneI"	"[YneI, Sad]"
"CPLX0-7788"	""	"[]"
"NQOR-CPLX"	""	"[]"
"EG11702-MONOMER"	"NudC"	"[NudC, YjaD]"
"NADH-DHI-CPLX"	"NDH-1"	"[NDH-1, NADH dhI, complex I, NADH dehydrogenase I]"
"CPLX0-3361"	"soluble NADH dehydrogenase fragment"	"[soluble NADH dehydrogenase fragment, connecting fragment of NADH dehydrogenase I]"
"SUCCSEMIALDDEHYDROG-MONOMER"	"GabD"	"[GabD]"
"G7564-MONOMER"	"YqhD"	"[YqhD]"
"G6760-MONOMER"	"YncB"	"[YncB, CurA]"
"MONOMER0-146"	"YcbP"	"[YcbP, SsuE]"
"EG11261-MONOMER"	"YbjB"	"[YbjB, NfsA, MdaA]"
"EG12656-MONOMER"	"MdaB"	"[MdaB, NADPH quinone reductase]"
"EG10564-MONOMER"	"MalY"	"[MalY, bifunctional &beta;-cystathionase, PLP-dependent and regulator of maltose regulon]"
"EG10735-MONOMER"	"Pst"	"[Pst, PhoT, PhoU]"
"ABC-20-CPLX"	""	"[]"
"DMBPPRIBOSYLTRANS-MONOMER"	"CobT"	"[CobT]"
"CPLX0-7707"	""	"[]"
"NITRATREDUCTA-CPLX"	"NRA"	"[NRA, quinol:nitrate oxidoreductase]"
"NITRATREDUCTZ-CPLX"	"NRZ"	"[NRZ, quinol:nitrate oxidoreductase]"
"NITRITREDUCT-CPLX"	"NirB"	"[NirB]"
"PROTEIN-PII2"	"YbaI"	"[YbaI, GlnK, unmodified protein PII 2, [protein PII2], PII2, nitrogen regulatory protein GlnK, nitrogen regulator PII 2]"
"PROTEIN-PII"	"GlnB"	"[GlnB, [protein PII], unmodified PII, PII, regulatory protein P-II; regulation of nitrogen metabolism and fatty acid biosynthesis]"
"G7409-MONOMER"	"PncC"	"[PncC, YgaD]"
"EG11580-MONOMER"	"YbiB"	"[YbiB]"
"MONOMER0-4198"	""	"[]"
"EG11191-MONOMER"	"YicB"	"[YicB, Ttk, SlmA]"
"NUCLEOSIDE-DIP-KIN-MONOMER"	"Ndk"	"[Ndk]"
"EG11298-MONOMER"	"YhdE"	"[YhdE]"
"EG10572-MONOMER"	"MazG"	"[MazG]"
"EG10416-MONOMER"	"GrpE"	"[GrpE, heat shock protein GrpE]"
"CPLX0-7879"	"NusB-NusE complex"	"[NusB-NusE complex]"
"G6550-MONOMER"	"YmdB"	"[YmdB]"
"ACSERLYA-MONOMER"	"Ssi5"	"[Ssi5, CysK]"
"O-SUCCINYLBENZOATE-COA-LIG-MONOMER"	"MenE"	"[MenE]"
"O-SUCCHOMOSERLYASE-MONOMER"	"MetB"	"[MetB]"
"ABC-22-CPLX"	""	"[]"
"G7842-MONOMER"	"YjeR"	"[YjeR, Orn]"
"PHOSPHO-OMPR-MONOMER"	""	"[]"
"CHAINF-MONOMER"	"ArgF"	"[ArgF, ornithine carbamoyltransferase chain F]"
"CHAINI-MONOMER"	"ArgI"	"[ArgI, ornithine carbamoyltransferase chain I]"
"ORNDECARBOX-BIO-MONOMER"	"SpeC"	"[SpeC]"
"ORNDECARBOXDEG-MONOMER"	"SpeF"	"[SpeF]"
"OROPRIBTRANS-MONOMER"	"PyrE"	"[PyrE]"
"OROTPDECARB-MONOMER"	"PyrF"	"[PyrF]"
"PROP-MONOMER"	"ProP proline/betaine MFS transporter"	"[ProP proline/betaine MFS transporter, ProP, proline permease II, proline porter II]"
"EG10680-MONOMER"	"OsmC"	"[OsmC, osmotically inducible protein]"
"EG11009-MONOMER"	"WeeA"	"[WeeA, Toc, RefI, MukA, MtcB, TolC]"
"MONOMER0-341"	"PldA"	"[PldA, OMPLA, Outer Membrane Phospholipase A]"
"EG10670-MONOMER"	"Par"	"[Par, MeoA, outer membrane protein A<sub>2</sub>, outer membrane protein Ib, outer membrane protein 4, outer membrane protein 0-8, OmpC]"
"EG10671-MONOMER"	"NfxB"	"[NfxB, TolF, Cry, CmlB, outer membrane protein F, colB, outer membrane protein A<sub>1</sub>, outer membrane protein 1a, outer membrane protein 4, outer membrane protein b, outer membrane protein 0-9, OmpF]"
"MONOMER0-282"	"OmpE"	"[OmpE, outer membrane pore protein E (E,Ic,NmpAB), PhoE, outer membrane phosphoporin]"
"CPLX0-3933"	""	"[]"
"G7236-MONOMER"	"YfdU"	"[YfdU, Oxc]"
"G6783-MONOMER"	"PdeO"	"[PdeO, YddU, Dos, DosP, c-di-GMP phosphodiesterase, heme-regulated]"
"CPLX0-7844"	""	"[]"
"CPLX0-7988"	""	"[]"
"PANTEPADENYLYLTRAN-MONOMER"	"YicA"	"[YicA, KdtB, CoaD, PPAT]"
"PANTOTHENATE-KIN-MONOMER"	"Rts"	"[Rts, PanK, CoaA]"
"PANTOATE-BETA-ALANINE-LIG-MONOMER"	"PanC"	"[PanC]"
"PABSYNMULTI-CPLX"	""	"[]"
"EG11132-MONOMER"	"PpsR"	"[PpsR, YdiA]"
"EG11676-MONOMER"	"ClpQ"	"[ClpQ, YiiC, HtpO, HslV]"
"EG10695-MONOMER"	"PepD"	"[PepD, PepH]"
"EG11549-MONOMER"	"PepT"	"[PepT]"
"SBMA-MONOMER"	"SbmA"	"[SbmA]"
"EG10580-MONOMER"	"MepA"	"[MepA]"
"CPLX0-8179"	"LpoA-MrcA complex"	"[LpoA-MrcA complex]"
"CPLX0-8178"	""	"[]"
"EG10748-MONOMER"	"PonA"	"[PonA, MrcA, PBP1a, penicillin binding protein 1a]"
"EG10605-MONOMER"	"PonB"	"[PonB, PbpF, PBP1B, PBP1Bs, MrcB]"
"G7350-MONOMER"	"PatZ"	"[PatZ, Pka, YfiQ]"
"EG11399-MONOMER"	"YhhD"	"[YhhD, YhiC, HdeB, 10K-L protein]"
"EG10455-MONOMER"	"Skp"	"[Skp, OmpH, HlpA, HLP-I]"
"G6104-MONOMER"	"Ivy"	"[Ivy, YkfE]"
"NAP-CPLX"	"Nap"	"[Nap]"
"NRFMULTI-CPLX"	""	"[]"
"APPA-MONOMER"	"AppA"	"[AppA]"
"G7816-MONOMER"	"CpxP"	"[CpxP, YiiO]"
"CPLX0-8213"	"quinol:protein L-methionine sulfoxide oxidoreductase"	"[quinol:protein L-methionine sulfoxide oxidoreductase]"
"G7682-MONOMER"	"HhoA"	"[HhoA, DegQ]"
"EG10463-MONOMER"	"Ptd"	"[Ptd, protease Do, HtrA, DegP]"
"G7394-MONOMER"	"YgaT"	"[YgaT, CsiD]"
"EG12391-MONOMER"	"YdiE"	"[YdiE, conserved protein YdiE]"
"PHENDEHYD-MONOMER"	"YdbG"	"[YdbG, PadA, FeaB]"
"CPLX0-1762"	""	"[]"
"G6717-MONOMER"	"YdbV"	"[YdbV, PaaI]"
"PHES-CPLX"	"PheRS"	"[PheRS]"
"G7492-MONOMER"	"YgeZ"	"[YgeZ, HyuA]"
"ABC-27-CPLX"	"pstSCAB"	"[pstSCAB]"
"PHOSACETYLTRANS-MONOMER"	"Pta"	"[Pta]"
"G7288-MONOMER"	"YpfA"	"[YpfA, EutD, EutI]"
"PHOSPHASERDECARB-CPLX"	""	"[]"
"PHOSPHASERDECARB-DIMER"	""	"[]"
"PHOSPHASERSYN-MONOMER"	"Pss"	"[Pss, PssA]"
"PAPSSULFOTRANS-MONOMER"	"CysH"	"[CysH]"
"G7192-MONOMER"	"YfcE"	"[YfcE]"
"PEPCARBOX-MONOMER"	"Glu"	"[Glu, Asp, Ppc]"
"PEPSYNTH-MONOMER"	"Pps"	"[Pps, PpsA]"
"PGLYCDEHYDROG-MONOMER"	"SerA"	"[SerA]"
"SAICARSYN-MONOMER"	"Ade"	"[Ade, PurC]"
"AIRS-MONOMER"	"PurI"	"[PurI, PurG, PurM]"
"PHOSPHO-CPXR"	"CpxR response regulator - phosphorylated"	"[CpxR response regulator - phosphorylated]"
"PSERTRANSAM-MONOMER"	"SerC"	"[SerC, PdxF, PdxC]"
"CPLX0-7994"	"UDP-<i>N</i>-acetyl-D-glucosamine &beta;-1,6-N-acetyl-D-glucosaminyl transferase"	"[UDP-<i>N</i>-acetyl-D-glucosamine &beta;-1,6-N-acetyl-D-glucosaminyl transferase, PgaCD, poly-&beta;-1,6-<i>N</i>-acetyl-D-glucosamine synthase, PGA synthase]"
"EG10743-MONOMER"	"Bfl"	"[Bfl, Pnp]"
"PPK-MONOMER"	"Ppk"	"[Ppk]"
"CPLX0-7529"	""	"[]"
"PORPHOBILSYNTH-MONOMER"	"Ncf"	"[Ncf, HemB]"
"CPLX0-1841"	""	"[]"
"EG10244-MONOMER"	"DnaT"	"[DnaT]"
"EG10764-MONOMER"	"PriB"	"[PriB]"
"CPLX0-3922"	""	"[]"
"EG10697-MONOMER"	"PepP"	"[PepP]"
"PROS-MONOMER"	"DrpA"	"[DrpA, Drp, ProS, ProRS]"
"EG11105-MONOMER"	"YbdB"	"[YbdB, EntH]"
"EG10968-MONOMER"	"SppA"	"[SppA]"
"DSBC-MONOMER"	"XprA"	"[XprA, DsbC]"
"MONOMER0-1564"	"Gef"	"[Gef, HokC, HokC, Gef toxin; interferes with membrane function when in excess]"
"SECA"	"Pea"	"[Pea, Azi, PrlD, SecA]"
"G7055-MONOMER"	"YzzC"	"[YzzC, YedU, HchA, Hsp31, glyoxalase III, Maillard deglycase 1]"
"HMP-KIN-MONOMER"	"YajL"	"[YajL, ThiJ, chaperone, protecting proteins in response to oxidative stress, Maillard deglycase 3]"
"PROTOPORGENOXI-MONOMER"	"YihB"	"[YihB, HemG]"
"EG12033-MONOMER"	"PsuG"	"[PsuG, YeiN, PscG]"
"PTSI-MONOMER"	"Ctr"	"[Ctr, PtsI, EI]"
"EG12172-MONOMER"	"YcfF"	"[YcfF, HinT]"
"DEOD-MONOMER"	"Pup"	"[Pup, DeoD]"
"HCAMULTI-CPLX"	"3-phenylpropionate dioxygenase complex"	"[3-phenylpropionate dioxygenase complex, 3-phenylpropionate dioxygenase system]"
"EG11761-MONOMER"	"PptA"	"[PptA, YdcE]"
"CPLX0-8120"	""	"[]"
"EG11811-MONOMER"	"AidB"	"[AidB, isovaleryl-CoA dehydrogenase and DNA-binding transcriptional repressor]"
"G7489-MONOMER"	"YgeW"	"[YgeW]"
"G7286-MONOMER"	"YffY"	"[YffY, EutN, CchB]"
"ABC-59-CPLX"	""	"[]"
"G7626-MONOMER"	"YhaR"	"[YhaR, TdcF]"
"EG11241-MONOMER"	"YcaC"	"[YcaC]"
"CPLX0-8238"	""	"[]"
"G6895-MONOMER"	"YdhR"	"[YdhR]"
"CPLX0-7807"	""	"[]"
"EG11100-MONOMER"	"YbaB"	"[YbaB, conserved DNA-binding protein YbaB]"
"ABC-41-CPLX"	""	"[]"
"EG11134-MONOMER"	"YdjA"	"[YdjA]"
"MONOMER0-1701"	"Sfa"	"[Sfa, YccL, GnsA]"
"CPLX-159"	"EII<sup>Frv</sup>"	"[EII<sup>Frv</sup>, Enzyme II<sup>Frv</sup>]"
"CPLX-160"	"EII<sup>Frw</sup>"	"[EII<sup>Frw</sup>, Enzyme II<sup>Frw</sup>]"
"CPLX0-8119"	""	"[]"
"EIISGC"	"EII<sup>Sgc</sup>"	"[EII<sup>Sgc</sup>, Enzyme II<sup>Sgc</sup>]"
"EG12657-MONOMER"	"YgiN"	"[YgiN]"
"QOR-MONOMER"	"Hzc"	"[Hzc, Hcz, Qor, QorA]"
"EG12309-MONOMER"	"LasT"	"[LasT, YjtD]"
"G7292-MONOMER"	"YpfE"	"[YpfE, EutS]"
"G7271-MONOMER"	"YffJ"	"[YffJ, EutL]"
"G7287-MONOMER"	"YffZ"	"[YffZ, EutM, CchA]"
"ABC-21-CPLX"	""	"[]"
"ABC-48-CPLX"	""	"[]"
"ABC-61-CPLX"	""	"[]"
"ABC-60-CPLX"	""	"[]"
"ABC-52-CPLX"	""	"[]"
"ABC-55-CPLX"	""	"[]"
"ABC-51-CPLX"	""	"[]"
"CPLX0-761"	""	"[]"
"ABC-29-CPLX"	""	"[]"
"ABC-25-CPLX"	""	"[]"
"G7596-MONOMER"	"PatA"	"[PatA, YgjG, Oat, Pat]"
"PYRNUTRANSHYDROGEN-CPLX"	"PntAB"	"[PntAB]"
"PDXH-MONOMER"	"PdxH"	"[PdxH, pyridoxine/pyridoxamine 5'-phosphate oxidase]"
"PDXY-MONOMER"	"YdgS"	"[YdgS, PdxY]"
"PDXK-MONOMER"	"PdxL"	"[PdxL, ThiJ, YfeI, PdxK, PLK1]"
"PDXJ-MONOMER"	"PdxJ"	"[PdxJ]"
"EG12030-MONOMER"	"YeiK"	"[YeiK, RihB, ribonucleoside hydrolase 2 (pyrimidine-specific)]"
"PYRROLINECARBREDUCT-MONOMER"	"ProC"	"[ProC]"
"PYRUVATEDEH-CPLX"	""	"[]"
"E1P-MONOMER"	"AceE"	"[AceE, subunit of E1p component of pyruvate dehydrogenase complex]"
"PYRUVFORMLY-MONOMER"	"Pfl"	"[Pfl, PflB]"
"PKI-MONOMER"	"PykF"	"[PykF]"
"PKII-MONOMER"	"PykA"	"[PykA]"
"PYRUVOXID-MONOMER"	"PoxB"	"[PoxB]"
"EG10836-MONOMER"	"RelB"	"[RelB, Qin prophage; antitoxin of the RelE-RelB toxin-antitoxin system and DNA binding transcriptional repressor RelB, Qin prophage; antitoxin RelB]"
"QUINOPRIBOTRANS-MONOMER"	"NadC"	"[NadC]"
"QUINOLINATE-SYNTHA-MONOMER"	"NicA"	"[NicA, NadA]"
"G6379-MONOMER"	"YbgI"	"[YbgI, conserved metal-binding protein]"
"PC00084"	"RcsAB"	"[RcsAB]"
"CPLX0-7916"	"RcsBgl"	"[RcsBgl]"
"CPLX0-7978"	""	"[]"
"RECFOR-CPLX"	""	"[]"
"EG11404-MONOMER"	"YchF"	"[YchF, ribosome-binding ATPase, inhibitor of catalase activity, ribosome-binding ATPase YchF]"
"G6606-MONOMER"	"YmgB"	"[YmgB, AriR]"
"EG10018-MONOMER"	"YhdA"	"[YhdA, CsrD]"
"EG11568-MONOMER"	"KefF"	"[KefF, YabF]"
"EG11731-MONOMER"	"YieN"	"[YieN, RavA]"
"CPLX0-7791"	"RelBE"	"[RelBE]"
"EG10236-MONOMER"	"GrpD"	"[GrpD, GrpA, GroP, DnaB]"
"RUVABC-CPLX"	"RuvABC"	"[RuvABC]"
"RHAMNULPALDOL-MONOMER"	"RhaD"	"[RhaD]"
"EG10844-MONOMER"	"MmrA"	"[MmrA, RhlB]"
"RIBOFLAVIN-SYN-MONOMER"	"RibC"	"[RibC, RibE]"
"RIBOKIN-MONOMER"	"RbsK"	"[RbsK]"
"G7175-MONOMER"	"Rnz"	"[Rnz, EcoZ, ZipD, ElaC, Rbn]"
"EG10859-MONOMER"	"SmbB"	"[SmbB, Ams, Rne]"
"EG11879-MONOMER"	"YiiV"	"[YiiV, MenG, RraA]"
"G7885-MONOMER"	"YjgD"	"[YjgD, RraB]"
"RIBONUCLEOSIDE-DIP-REDUCTI-CPLX"	"ribonucleotide reductase I"	"[ribonucleotide reductase I, RDPR-I]"
"NRDA-MONOMER"	"DnaF"	"[DnaF, NrdA]"
"NRDB-MONOMER"	"FtsB"	"[FtsB, NrdB, ribonucleoside diphosphate reductase 1, &beta; subunit, ferritin-like]"
"RIBONUCLEOSIDE-DIP-REDUCTII-CPLX"	"RDPR-II"	"[RDPR-II]"
"NRDE-MONOMER"	"NrdE"	"[NrdE]"
"NRDF-MONOMER"	"YgaD"	"[YgaD, NrdF]"
"ABC-28-CPLX"	""	"[]"
"RIB5PISOMA-MONOMER"	"YgfC"	"[YgfC, RpiA]"
"EG10852-MONOMER"	"Nek"	"[Nek, RimK]"
"EG11430-MONOMER"	"RoxA"	"[RoxA, YcfD]"
"G7602-MONOMER"	"YgjN"	"[YgjN, HigB, translation-dependent mRNA interferase, toxin of the HigB-HigA toxin-antitoxin system]"
"RIBULOKIN-MONOMER"	"AraB"	"[AraB]"
"CPLX0-221"	"sigma fecI"	"[sigma fecI]"
"RNAPE-CPLX"	"RNA polymerase sigma E"	"[RNA polymerase sigma E, RNA polymerase sigma 24 holoenzyme]"
"CPLX0-222"	"RNA polymerase sigma 28 holoenzyme"	"[RNA polymerase sigma 28 holoenzyme, RNA polymerase sigma F]"
"RNAP32-CPLX"	"RNA polymerase sigma 32 holoenzyme"	"[RNA polymerase sigma 32 holoenzyme, RNA polymerase sigma H]"
"RNAP54-CPLX"	"RNA polymerase sigma 54 holoenzyme"	"[RNA polymerase sigma 54 holoenzyme, RNA polymerase sigmaN]"
"RNAP70-CPLX"	"RNA polymerase sigma 70 holoenzyme"	"[RNA polymerase sigma 70 holoenzyme, RNA polymerase sigma D]"
"RNAPS-CPLX"	"RNA polymerase sigma 38"	"[RNA polymerase sigma 38, RNA polymerase sigma 38 holoenzyme]"
"APORNAP-CPLX"	""	"[]"
"EG10438-MONOMER"	"Hfq"	"[Hfq, HF-I, host factor I]"
"EG12146-MONOMER"	"RapZ"	"[RapZ, YhbJ]"
"EG11299-MONOMER"	"AdhR"	"[AdhR, Rng, YhdF, CafA]"
"EG10857-MONOMER"	"RanA"	"[RanA, Rnc]"
"EG11547-MONOMER"	"Rnt"	"[Rnt]"
"CPLX0-7909"	""	"[]"
"ADHC-MONOMER"	"AdhC"	"[AdhC, FrmA, formaldehyde dehydrogenase]"
"SAMDECARB-CPLX"	""	"[]"
"EG12026-MONOMER"	"YeiG"	"[YeiG]"
"CPLX0-8208"	"S6:S18"	"[S6:S18]"
"SEC-SECRETION-CPLX"	"Sec translocation complex"	"[Sec translocation complex]"
"SECD-SECF-YAJC-YIDC-CPLX"	""	"[]"
"SECB"	"SecB"	"[SecB]"
"SECE-G-Y-CPLX"	""	"[]"
"CPLX0-1601"	"YnfFGH"	"[YnfFGH, YnfEFGH]"
"EG10943-MONOMER"	"FdhB"	"[FdhB, SelD]"
"EG10941-MONOMER"	"FdhA"	"[FdhA, SelA]"
"ARCB-MONOMER"	"ArcB"	"[ArcB]"
"ATOS-MONOMER"	"AtoS"	"[AtoS]"
"CREC-MONOMER"	"PhoM"	"[PhoM, CreC]"
"ENVZ-MONOMER"	"Tpo"	"[Tpo, OmpB, PerA, EnvZ]"
"KDPD-MONOMER"	"Kac"	"[Kac, KdpD]"
"NARQ-MONOMER"	"nitrate/nitrite sensor kinase"	"[nitrate/nitrite sensor kinase, NarQ]"
"NARX-MONOMER"	"NarR"	"[NarR, FrdR, NarX]"
"PROTEIN-NRII"	"GlnL"	"[GlnL, GlnR, NtrB]"
"PHOQ-MONOMER"	""	"[]"
"PHOR-MONOMER"	"NmpB"	"[NmpB, PhoR]"
"TORS-MONOMER"	"YccI"	"[YccI, TorS]"
"SERINE-O-ACETTRAN-MONOMER"	"CysE"	"[CysE]"
"EG11652-MONOMER"	"HtrH"	"[HtrH, HhoB, DegS]"
"GLYOHMETRANS-MONOMER"	"GlyA"	"[GlyA]"
"EG10255-MONOMER"	"Eti"	"[Eti, Eco]"
"SERS-MONOMER"	"SerS"	"[SerS, SerRS]"
"EG11234-MONOMER"	"YdiB"	"[YdiB]"
"SIROHEMESYN-MONOMER"	"CysG"	"[CysG]"
"EG11160-MONOMER"	"MscS"	"[MscS, YggB]"
"MONOMER0-82"	"YnaI"	"[YnaI]"
"EG11534-MONOMER"	"HtpN"	"[HtpN, HslT, IbpA]"
"EG11535-MONOMER"	"HslS"	"[HslS, HtpE, IbpB]"
"ABC-34-CPLX"	""	"[]"
"UDHA-MONOMER"	"SthA"	"[SthA, Sth, UdhA]"
"SORB6PDEHYDROG-MONOMER"	"GutD"	"[GutD, SrlD]"
"CPLX-169"	"EII<sup>Gut</sup>"	"[EII<sup>Gut</sup>, Enzyme II<sup>Gut</sup>, glucitol PTS permease]"
"SPERMACTRAN-MONOMER"	"SpeG"	"[SpeG]"
"ABC-24-CPLX"	""	"[]"
"SPERMIDINESYN-MONOMER"	"SpeE"	"[SpeE]"
"EG11064-MONOMER"	"UvrE"	"[UvrE, SrjC, Rad, Dda, RecL, PdeB, MutU, UvrD]"
"EG10976-MONOMER"	"LexC"	"[LexC, ExrB, Ssb]"
"EG11415-MONOMER"	"Vtm"	"[Vtm, PexB, Dps]"
"E1O-MONOMER"	"Lys"	"[Lys, SucA, E1(o) subunit]"
"CPLX0-8160"	"complex II"	"[complex II, succinate-ubiquinone oxidoreductase, SQR, SdhCDAB, succinate dehydrogenase, succinate-Q reductase]"
"SUCC-DEHASE"	"SQR"	"[SQR]"
"SUCCCOASYN"	""	"[]"
"MONOMER0-1981"	"MsgB"	"[MsgB, DapE]"
"SUCCORNTRANSAM-MONOMER"	"AstC"	"[AstC, YdjW, CstC, ArgM]"
"CPLX0-1341"	""	"[]"
"SULFATE-ADENYLYLTRANS-CPLX"	""	"[]"
"ABC-70-CPLX"	""	"[]"
"ALPHACOMP-MONOMER"	"CysJ"	"[CysJ, SiR-FP, &alpha; subunit]"
"EG11845-MONOMER"	"SquS"	"[SquS, YihS]"
"G6905-MONOMER"	"YnhA"	"[YnhA, SufE]"
"G7455-MONOMER"	"YgdK"	"[YgdK, CsdE, CSD sulfur transfer protein CsdE]"
"CPLX-3942"	""	"[]"
"EG11859-MONOMER"	"FdhD"	"[FdhD]"
"SUPEROX-DISMUTFE-MONOMER"	"SodB"	"[SodB]"
"SUPEROX-DISMUTMN-MONOMER"	"SodA"	"[SodA, MnSOD]"
"CPLX0-240"	""	"[]"
"CPLX0-241"	""	"[]"
"G6278-MONOMER"	"YbbQ"	"[YbbQ, GlxR]"
"ABC-64-CPLX"	""	"[]"
"MONOMER0-147"	"YaiG"	"[YaiG, SsiD, TauD]"
"EG11884-MONOMER"	"TehB"	"[TehB]"
"MONOMER0-2001"	"Ssa"	"[Ssa, DapD]"
"CPLX0-2201"	""	"[]"
"ABC-32-CPLX"	""	"[]"
"CPLX0-3949"	""	"[]"
"THIOREDOXIN-REDUCT-NADPH-MONOMER"	"TrxB"	"[TrxB, thioredoxin reductase (NADPH), TrxR]"
"EG10395-MONOMER"	"GlpE"	"[GlpE]"
"G7398-MONOMER"	"YgaP"	"[YgaP]"
"ABC-7-CPLX"	""	"[]"
"THREDEHYDSYN-MONOMER"	"Ile"	"[Ile, IlvA]"
"THREODEHYD-MONOMER"	"Tdh"	"[Tdh]"
"THRS-MONOMER"	"ThrS"	"[ThrS, ThrRS]"
"DEOA-MONOMER"	"Ttg"	"[Ttg, Tpp, DeoA]"
"THYMIDYLATESYN-MONOMER"	"ThyA"	"[ThyA]"
"TRANSENOYLCOARED-CPLX"	""	"[]"
"TRANSALDOLB-MONOMER"	"YaaK"	"[YaaK, TalB]"
"EG12179-MONOMER"	"MsmC"	"[MsmC, GicA, CspE]"
"EG10845-MONOMER"	"RnsC"	"[RnsC, Tsu, Sun, NusD, Psu, SbaA, PsuA, NitA, Rho, transcription termination factor Rho;  polarity suppressor]"
"EG10116-MONOMER"	"BglC"	"[BglC, BglG]"
"TRANSKETOI-MONOMER"	"TktA"	"[TktA, Tkt, transketolase I]"
"TRANSKETOII-MONOMER"	"TktB"	"[TktB, transketolase II]"
"CPLX0-7976"	"TAM"	"[TAM, TamAB]"
"CPLX-168"	"EII<sup>Tre</sup>"	"[EII<sup>Tre</sup>, Enzyme II <sup>Tre</sup>]"
"TPI-MONOMER"	"Tpi"	"[Tpi, TpiA]"
"EG11888-MONOMER"	"TrmL"	"[TrmL, YibK]"
"EG11372-MONOMER"	"TadA"	"[TadA, YfhC, tRNA-specific adenosine deaminase]"
"G7327-MONOMER"	"YfhQ"	"[YfhQ, TrmJ, TrMet(Xm32)]"
"G6675-MONOMER"	"TtcA"	"[TtcA, YdaO, tRNA C32 thiolase]"
"EG11023-MONOMER"	"TrmD"	"[TrmD]"
"EG10454-MONOMER"	"LeuK"	"[LeuK, HisT, AsuC, TruA]"
"G7456-MONOMER"	"TcdA"	"[TcdA, CsdL, YgdL, CSD sulfur transfer protein]"
"G7021-MONOMER"	"YecP"	"[YecP, CmoB]"
"EG10996-MONOMER"	"Tgt"	"[Tgt]"
"EG10863-MONOMER"	"Rph"	"[Rph, truncated ribonuclease PH]"
"TRYPSYN"	""	"[]"
"TRYPSYN-BPROTEIN"	"TrpB"	"[TrpB, &beta; subunit]"
"TRPS-MONOMER"	"TrpS"	"[TrpS, TrpRS]"
"TRYPTOPHAN-MONOMER"	"TnaA"	"[TnaA, Ind, TnaR]"
"TATABCE-CPLX"	"Tat system"	"[Tat system, Tat translocase, TatABCE, TatABC]"
"EG10311-MONOMER"	"FimD_1"	"[FimD_1, FimD, FimD_2]"
"CPLX0-3382"	"GspC-O secreton  complex"	"[GspC-O secreton  complex]"
"TYRB-MONOMER"	"TyrB"	"[TyrB]"
"TYRS-MONOMER"	"TyrS"	"[TyrS]"
"CPLX0-3241"	""	"[]"
"UDPHYDROXYMYRGLUCOSAMNACETYLTRANS-MONO"	"OmsA"	"[OmsA, Ssc, HlpA, FirA, LpxD]"
"UDPGLUCEPIM-MONOMER"	"GalD"	"[GalD, GalE]"
"UGD-MONOMER"	"Udg"	"[Udg, YefA, Ugd, PmrE]"
"UDPMANNACADEHYDROG-MONOMER"	"MnaB"	"[MnaB, Rff, RffD, WecC]"
"UDPGLCNACEPIM-MONOMER"	"MnaA"	"[MnaA, YifF, RffE, NfrC, WecB]"
"UDPNACETYLGLUCOSAMACYLTRANS-MONOMER"	"LpxA"	"[LpxA]"
"GLCNACPTRANS-MONOMER"	"WecA"	"[WecA, Rfe]"
"UDP-NACMUR-ALA-LIG-MONOMER"	"MurC"	"[MurC]"
"PHOSPHO-UHPA"	"UhpA"	"[UhpA]"
"UMPKI-MONOMER"	"Umk"	"[Umk, SmbA, PyrH]"
"UPPSYN-MONOMER"	"IspU"	"[IspU, Rth, YaeS, UppS]"
"CPLX0-7720"	""	"[]"
"G6334-MONOMER"	"YzzU"	"[YzzU, UspG, YbdQ, UP12, universal stress protein UP12]"
"URAA-MONOMER"	"UraA"	"[UraA, uracil NCS2 transporter]"
"URACIL-PRIBOSYLTRANS-MONOMER"	"UraP"	"[UraP, Upp]"
"G6286-MONOMER"	"YlbC"	"[YlbC, AllD]"
"URPHOS-MONOMER"	"Udp"	"[Udp]"
"GLUC1PURIDYLTRANS-MONOMER"	"GalU"	"[GalU, YchD]"
"ABC-5-CPLX"	""	"[]"
"CPLX0-1924"	""	"[]"
"AQPZ-MONOMER"	"BniP"	"[BniP, AqpZ]"
"EG10698-MONOMER"	"PepQ"	"[PepQ]"
"GPT-MONOMER"	"Gxu"	"[Gxu, Gpp, GlyD, Gpt]"
"XANTHOSINEPHOSPHORY-MONOMER"	"PndA"	"[PndA, XapA]"
"CPLX0-3959"	""	"[]"
"ABC-33-CPLX"	"XylFGH"	"[XylFGH]"
"XYLISOM-MONOMER"	"XylA"	"[XylA]"
"XYLULOKIN-MONOMER"	"XylB"	"[XylB]"
"EG12844-MONOMER"	"YefM"	"[YefM]"
"CPLX0-3781"	"YefMB"	"[YefMB]"
"CPLX0-7624"	""	"[]"
"CPLX0-8188"	""	"[]"
"EG10596-MONOMER"	"MinB"	"[MinB, MinC]"
"EG11918-MONOMER"	"Zra"	"[Zra, YjaI, ZraP]"
"G6540-MONOMER"	"YcdX"	"[YcdX]"
"ABC-63-CPLX"	""	"[]"
"YIIP-MONOMER"	"YiiP"	"[YiiP, FieF]"
"CPLX0-7678"	""	"[]"
